year,fsize,firms,estabs,emp,denom,estabs_entry,estabs_entry_rate,estabs_exit,estabs_exit_rate,job_creation,job_creation_births,job_creation_continuers,job_creation_rate_births,job_creation_rate,job_destruction,job_destruction_deaths,job_destruction_continuers,job_destruction_rate_deaths,job_destruction_rate,net_job_creation,net_job_creation_rate,reallocation_rate,firmdeath_firms,firmdeath_estabs,firmdeath_emp
1978,a) 1 to 4,2161145,2169774,5299760,4957503,490484,23.290,362824,17.229,2052392,1265983,786409,25.537,41.400,1359283,905320,453963,18.262,27.419,693109,13.981,54.837,293010,293897,747685
1978,b) 5 to 9,664018,683318,4939858,4643968,45014,6.675,27025,4.008,1359370,512431,846939,11.034,29.272,770266,320328,449938,6.898,16.586,589104,12.685,33.173,20151,21109,266437
1978,c) 10 to 19,387792,427275,5717342,5403386,23130,5.468,14554,3.441,1381595,428231,953364,7.925,25.569,754213,274732,479481,5.084,13.958,627382,11.611,27.916,8146,9211,218201
1978,d) 20 to 99,304365,429805,12684778,12018456,28401,6.671,20295,4.767,2826367,748790,2077577,6.230,23.517,1495388,522870,972518,4.351,12.442,1330979,11.074,24.885,4607,6103,334949
1978,e) 100 to 499,45754,164849,9035205,8675623,16360,9.970,14860,9.056,1893199,479707,1413492,5.529,21.822,1175922,408937,766985,4.714,13.554,717277,8.268,27.109,385,980,136085
1978,f) 500 to 999,5624,53404,3440170,3349336,5523,10.409,4831,9.105,637942,160279,477663,4.785,19.047,455866,171010,284856,5.106,13.611,182076,5.436,27.221,32,94,42878
1978,g) 1000 to 2499,3520,66303,4477857,4381284,6240,9.412,6236,9.406,725015,196449,528566,4.484,16.548,532360,212992,319368,4.861,12.151,192655,4.397,24.302,13,78,38307
1978,h) 2500 to 4999,1400,57127,3389186,3324433,4905,8.611,4577,8.035,533808,154797,379011,4.656,16.057,404353,146716,257637,4.413,12.163,129455,3.894,24.326,D,D,D
1978,i) 5000 to 9999,851,50635,3589292,3498582,4313,8.606,3276,6.537,571729,146711,425018,4.193,16.342,389093,115449,273644,3.300,11.121,182636,5.220,22.243,D,D,D
1978,j) 10000+,742,222539,17567664,17305925,16035,7.240,13917,6.284,2260999,500363,1760636,2.891,13.065,1734026,486006,1248020,2.808,10.020,526973,3.045,20.040,D,D,D
1979,a) 1 to 4,2185998,2193674,5308660,5098333,480820,22.511,365282,17.102,1951468,1250251,701217,24.523,38.277,1531016,946200,584816,18.559,30.030,420452,8.247,60.059,292426,293508,770387
1979,b) 5 to 9,704073,723912,5143332,4978167,40395,5.611,32369,4.496,1308128,489460,818668,9.832,26.277,980630,384795,595835,7.730,19.699,327498,6.579,39.397,23296,24319,307690
1979,c) 10 to 19,417547,456794,6058303,5866520,18749,4.117,16074,3.529,1320737,389582,931155,6.641,22.513,936914,320830,616084,5.469,15.971,383823,6.543,31.941,9260,10139,246722
1979,d) 20 to 99,332595,460218,13695633,13252595,21449,4.686,16515,3.608,2626974,608878,2018096,4.594,19.822,1738803,514831,1223972,3.885,13.120,888171,6.702,26.241,4721,5757,335848
1979,e) 100 to 499,49853,176978,9780666,9480653,14425,8.277,9036,5.185,1724350,414816,1309534,4.375,18.188,1123849,297397,826452,3.137,11.854,600501,6.334,23.708,313,689,101050
1979,f) 500 to 999,5866,54961,3642656,3548840,4703,8.673,3236,5.967,560996,148373,412623,4.181,15.808,371318,102891,268427,2.899,10.463,189678,5.345,20.926,17,128,23335
1979,g) 1000 to 2499,3594,71594,4731314,4571816,7095,10.156,3633,5.200,695917,190284,505633,4.162,15.222,379822,96474,283348,2.110,8.308,316095,6.914,16.616,D,D,D
1979,h) 2500 to 4999,1435,54949,3523925,3397267,6692,12.608,2950,5.558,564032,190836,373196,5.617,16.603,314467,94453,220014,2.780,9.256,249565,7.346,18.513,0,0,0
1979,i) 5000 to 9999,851,57314,3965984,3868610,4238,7.452,3353,5.896,565248,133617,431631,3.454,14.611,370881,95413,275468,2.466,9.587,194367,5.024,19.174,0,0,0
1979,j) 10000+,748,234486,18753352,18405532,17591,7.554,14354,6.164,2367089,540575,1826514,2.937,12.861,1658370,400343,1258027,2.175,9.010,708719,3.851,18.020,0,0,0
1980,a) 1 to 4,2202272,2210507,5203590,5174825,454554,20.777,409032,18.697,1761145,1178256,582889,22.769,34.033,1705471,1021712,683759,19.744,32.957,55674,1.076,65.914,328580,329809,834342
1980,b) 5 to 9,714991,734724,5024101,5054805,37907,5.174,33867,4.622,1102156,453879,648277,8.979,21.804,1162377,403797,758580,7.988,22.995,-60221,-1.191,43.608,25113,26163,332237
1980,c) 10 to 19,425994,464484,5959646,5982457,17605,3.794,16666,3.592,1106171,364216,741955,6.088,18.490,1151082,336751,814331,5.629,19.241,-44911,-0.751,36.980,10021,11002,269004
1980,d) 20 to 99,342668,468580,13656937,13646877,18672,3.993,16703,3.572,2210848,575349,1635499,4.216,16.200,2191649,528169,1663480,3.870,16.060,19199,0.141,32.119,5075,6348,363603
1980,e) 100 to 499,51705,183343,9937556,9867573,12948,7.132,9374,5.163,1488070,371006,1117064,3.760,15.080,1351418,328400,1023018,3.328,13.696,136652,1.385,27.391,326,752,111552
1980,f) 500 to 999,5913,57503,3632330,3598391,5003,8.835,3249,5.738,486081,141980,344101,3.946,13.508,418493,103029,315464,2.863,11.630,67588,1.878,23.260,14,58,18697
1980,g) 1000 to 2499,3713,71316,4824529,4749742,6982,10.015,3785,5.429,601547,170387,431160,3.587,12.665,450198,111226,338972,2.342,9.478,151349,3.186,18.957,D,D,D
1980,h) 2500 to 4999,1451,55832,3568898,3542636,4824,8.734,3622,6.558,436372,136125,300247,3.842,12.318,380219,103754,276465,2.929,10.733,56153,1.585,21.465,D,D,D
1980,i) 5000 to 9999,863,59801,3948593,3901359,4655,7.903,2851,4.840,474558,159314,315244,4.084,12.164,381701,89039,292662,2.282,9.784,92857,2.380,19.568,0,0,0
1980,j) 10000+,813,244209,19228859,19264816,15588,6.391,15006,6.152,2111037,508793,1602244,2.641,10.958,2183595,465875,1717720,2.418,11.335,-72558,-0.377,21.916,0,0,0
1981,a) 1 to 4,2226584,2234363,5273914,5230621,445891,20.058,423122,19.034,1783207,1174481,608726,22.454,34.092,1696952,1047634,649318,20.029,32.443,86255,1.649,64.885,336514,338188,853309
1981,b) 5 to 9,718604,739217,5108174,5063370,39416,5.358,32382,4.402,1166422,488322,678100,9.644,23.036,1077486,392184,685302,7.746,21.280,88936,1.756,42.560,24752,26110,327920
1981,c) 10 to 19,426275,465265,6025763,5979657,18853,4.069,15048,3.248,1174660,423839,750821,7.088,19.644,1081534,329898,751636,5.517,18.087,93126,1.557,36.174,10217,11258,274310
1981,d) 20 to 99,342870,471589,13735813,13622859,23402,5.006,15226,3.257,2335453,746302,1589151,5.478,17.144,2107348,525631,1581717,3.858,15.469,228105,1.674,30.938,5276,6690,371666
1981,e) 100 to 499,52119,189023,9948371,9885672,15376,8.266,9364,5.034,1517511,474381,1043130,4.799,15.351,1389717,311186,1078531,3.148,14.058,127794,1.293,28.116,340,900,114571
1981,f) 500 to 999,5985,58037,3611888,3578109,5601,9.882,2889,5.097,514015,166324,347691,4.648,14.366,444175,105155,339020,2.939,12.414,69840,1.952,24.827,13,240,18457
1981,g) 1000 to 2499,3874,72842,4892667,4859623,6955,9.761,3775,5.298,596767,197948,398819,4.073,12.280,531321,135266,396055,2.783,10.933,65446,1.347,21.867,8,25,26597
1981,h) 2500 to 4999,1511,62399,3697114,3686818,6201,10.224,2705,4.460,427339,144824,282515,3.928,11.591,404976,79866,325110,2.166,10.984,22363,0.607,21.969,0,0,0
1981,i) 5000 to 9999,913,63601,3856757,3830883,5799,9.323,2993,4.812,445575,139930,305645,3.653,11.631,393491,85209,308282,2.224,10.272,52084,1.360,20.543,D,D,D
1981,j) 10000+,891,254711,19556800,19598352,19134,7.568,15367,6.078,2175194,620696,1554498,3.167,11.099,2259295,475184,1784111,2.425,11.528,-84101,-0.429,22.198,0,0,0
1982,a) 1 to 4,2207346,2216037,5265205,5263898,438855,19.737,453808,20.410,1796968,1145107,651861,21.754,34.138,1792582,1136767,655815,21.596,34.054,4386,0.083,68.109,360658,362166,931331
1982,b) 5 to 9,720266,740929,5062448,5088849,39462,5.334,37122,5.018,1121616,448323,673293,8.810,22.041,1173556,432721,740835,8.503,23.061,-51940,-1.021,44.081,27503,28628,365587
1982,c) 10 to 19,424724,463417,5924139,5958326,20240,4.370,19714,4.256,1138252,394974,743278,6.629,19.104,1205502,376350,829152,6.316,20.232,-67250,-1.129,38.207,11497,12593,308832
1982,d) 20 to 99,339844,470929,13511751,13545841,20127,4.283,18098,3.851,2292078,653764,1638314,4.826,16.921,2361748,589048,1772700,4.349,17.435,-69670,-0.514,33.842,6184,7730,440333
1982,e) 100 to 499,52222,195396,9996283,9962330,12675,6.562,8188,4.239,1549161,411911,1137250,4.135,15.550,1483356,299930,1183426,3.011,14.890,65805,0.661,29.779,411,1021,133633
1982,f) 500 to 999,5865,61085,3566341,3551223,4542,7.538,2874,4.770,462025,115501,346524,3.252,13.010,431068,89170,341898,2.511,12.139,30957,0.872,24.277,13,62,17910
1982,g) 1000 to 2499,3938,76643,5047939,5010528,5969,7.873,4315,5.691,595909,173879,422030,3.470,11.893,519156,121954,397202,2.434,10.361,76753,1.532,20.723,7,8,22954
1982,h) 2500 to 4999,1496,59880,3664458,3660283,4757,8.055,3113,5.271,433473,136718,296755,3.735,11.843,421328,99367,321961,2.715,11.511,12145,0.332,23.022,0,0,0
1982,i) 5000 to 9999,907,69170,3973754,3986167,5841,8.532,4418,6.454,467852,162245,305607,4.070,11.737,493800,129157,364643,3.240,12.388,-25948,-0.651,23.474,0,0,0
1982,j) 10000+,969,263271,18873457,19217818,22631,8.651,19313,7.382,1989954,585227,1404727,3.045,10.355,2671542,579578,2091964,3.016,13.901,-681588,-3.547,20.709,0,0,0
1983,a) 1 to 4,2286552,2294893,5451327,5327610,489918,21.764,402297,17.871,1876696,1267283,609413,23.787,35.226,1628639,1019524,609115,19.137,30.570,248057,4.656,61.140,319547,321088,839532
1983,b) 5 to 9,731779,753070,5176847,5145937,39860,5.317,33125,4.418,1122947,468278,654669,9.100,21.822,1061912,399391,662521,7.761,20.636,61035,1.186,41.272,25818,27162,342498
1983,c) 10 to 19,424805,466247,5947405,5950170,19827,4.263,17557,3.775,1110595,399804,710791,6.719,18.665,1116325,356070,760255,5.984,18.761,-5730,-0.096,37.330,11172,12513,300092
1983,d) 20 to 99,337193,471249,13346360,13391553,22375,4.757,20540,4.367,2224321,659643,1564678,4.926,16.610,2311710,597986,1713724,4.465,17.262,-87389,-0.653,33.220,6086,8138,432547
1983,e) 100 to 499,51940,195591,9772674,9840942,14074,7.210,13273,6.800,1531947,433291,1098656,4.403,15.567,1667320,372144,1295176,3.782,16.943,-135373,-1.376,31.134,403,1134,132755
1983,f) 500 to 999,6082,61188,3535555,3564180,4626,7.581,4292,7.034,479700,134012,345688,3.760,13.459,537293,105916,431377,2.972,15.075,-57593,-1.616,26.918,5,5,6796
1983,g) 1000 to 2499,3984,75665,4925104,4929036,6324,8.395,5652,7.503,618816,216463,402353,4.392,12.555,627541,148642,478899,3.016,12.732,-8725,-0.177,25.109,5,6,16057
1983,h) 2500 to 4999,1584,60665,3618621,3666909,4891,8.124,3965,6.586,442843,150352,292491,4.100,12.077,540668,119631,421037,3.262,14.745,-97825,-2.668,24.153,D,D,D
1983,i) 5000 to 9999,991,67791,3959869,3981336,4896,7.212,5080,7.483,545775,192962,352813,4.847,13.708,589295,154986,434309,3.893,14.801,-43520,-1.093,27.417,D,D,D
1983,j) 10000+,1082,265660,18247973,18617005,17440,6.489,23630,8.792,2280898,558758,1722140,3.001,12.252,3032163,834981,2197182,4.485,16.287,-751265,-4.035,24.503,0,0,0
1984,a) 1 to 4,2392550,2400723,5831876,5523455,556413,23.955,400464,17.241,2186091,1462820,723271,26.484,39.578,1565043,1010396,554647,18.293,28.334,621048,11.244,56.669,322871,324645,839071
1984,b) 5 to 9,760896,782921,5548219,5343023,41192,5.291,32380,4.159,1356868,513096,843772,9.603,25.395,947120,387190,559930,7.247,17.726,409748,7.669,35.453,24954,26357,331451
1984,c) 10 to 19,439240,481200,6390686,6159449,18455,3.843,16398,3.415,1389077,418124,970953,6.788,22.552,926237,342760,583477,5.565,15.038,462840,7.514,30.075,10833,12228,291621
1984,d) 20 to 99,349453,483617,14468674,13892265,19801,4.108,16591,3.442,2878386,659795,2218591,4.749,20.719,1725676,546931,1178745,3.937,12.422,1152710,8.297,24.844,5681,7153,402745
1984,e) 100 to 499,53874,201289,10589251,10215042,14717,7.389,10513,5.278,1922195,425904,1496291,4.169,18.817,1172384,316279,856105,3.096,11.477,749811,7.340,22.954,381,695,128012
1984,f) 500 to 999,6085,64219,3805330,3678020,5156,8.131,3538,5.580,609845,160982,448863,4.377,16.581,356440,86637,269803,2.356,9.691,253405,6.890,19.382,9,9,12370
1984,g) 1000 to 2499,4005,79319,5148225,5034454,7019,9.003,4314,5.533,681966,190525,491441,3.784,13.546,458605,113244,345361,2.249,9.109,223361,4.437,18.219,6,25,16748
1984,h) 2500 to 4999,1618,60610,3878522,3761655,5271,8.855,3098,5.205,610722,195330,415392,5.193,16.235,375479,104187,271292,2.770,9.982,235243,6.254,19.964,3,3,21529
1984,i) 5000 to 9999,954,70088,4028732,3945416,5837,8.476,3397,4.933,560086,189762,370324,4.810,14.196,392058,87408,304650,2.215,9.937,168028,4.259,19.874,0,0,0
1984,j) 10000+,984,279692,19050175,18727334,24903,9.009,18382,6.650,2702011,1008721,1693290,5.386,14.428,2051800,633325,1418475,3.382,10.956,650211,3.472,21.912,D,D,D
1985,a) 1 to 4,2400409,2408261,5867461,5690377,540486,22.793,466436,19.671,2151226,1433646,717580,25.194,37.805,1792325,1197267,595058,21.040,31.497,358901,6.307,62.995,375276,377467,992173
1985,b) 5 to 9,788375,809844,5689380,5585513,42973,5.314,40606,5.021,1350468,535144,815324,9.581,24.178,1142897,499687,643210,8.946,20.462,207571,3.716,40.924,31993,33648,425510
1985,c) 10 to 19,456347,496292,6558664,6450604,19798,3.986,20594,4.146,1369402,440059,929343,6.822,21.229,1153171,471130,682041,7.304,17.877,216231,3.352,35.754,14695,16242,397816
1985,d) 20 to 99,365441,496405,14977267,14722197,18253,3.675,18856,3.796,2769513,688665,2080848,4.678,18.812,2259021,840810,1418211,5.711,15.344,510492,3.467,30.689,8929,11073,653345
1985,e) 100 to 499,57035,208519,11198062,10910200,14559,7.054,10331,5.005,1986349,456356,1529993,4.183,18.206,1410473,451606,958867,4.139,12.928,575876,5.278,25.856,713,1679,247891
1985,f) 500 to 999,6386,64625,3965721,3872257,5773,9.037,4285,6.708,672692,180346,492346,4.657,17.372,482784,150715,332069,3.892,12.468,189908,4.904,24.936,38,489,51559
1985,g) 1000 to 2499,4182,83074,5451565,5346649,7915,9.657,5685,6.936,778722,209640,569082,3.921,14.565,564751,178194,386557,3.333,10.563,213971,4.002,21.125,12,91,35011
1985,h) 2500 to 4999,1574,59614,3759431,3718984,5360,9.117,3720,6.327,535466,171021,364445,4.599,14.398,454252,147410,306842,3.964,12.214,81214,2.184,24.429,D,D,D
1985,i) 5000 to 9999,980,76505,4263209,4195139,6355,8.383,4967,6.552,636590,242884,393706,5.790,15.174,499974,141391,358583,3.370,11.918,136616,3.257,23.836,0,0,0
1985,j) 10000+,1030,283019,19960530,19736174,21770,7.649,24983,8.777,2703138,831963,1871175,4.215,13.696,2264528,769054,1495474,3.897,11.474,438610,2.222,22.948,0,0,0
1986,a) 1 to 4,2432418,2441118,5939118,5773282,539014,22.469,454619,18.951,2145673,1436147,709526,24.876,37.166,1809793,1190355,619438,20.618,31.348,335880,5.818,62.695,362483,364421,976589
1986,b) 5 to 9,812965,835199,5840063,5730101,46803,5.631,38691,4.655,1375227,554141,821086,9.671,24.000,1155341,479718,675623,8.372,20.163,219886,3.837,40.325,30797,32174,409323
1986,c) 10 to 19,474469,515765,6777745,6645045,25408,4.958,18787,3.666,1428976,496981,931995,7.479,21.504,1163336,421422,741914,6.342,17.507,265640,3.998,35.014,13353,14946,359289
1986,d) 20 to 99,382758,520956,15598511,15287500,33180,6.447,20585,4.000,3034465,931579,2102886,6.094,19.849,2411656,732610,1679046,4.792,15.775,622809,4.074,31.551,7479,9659,541799
1986,e) 100 to 499,59007,208467,11290630,11159871,16324,7.891,13142,6.353,2014833,545967,1468866,4.892,18.054,1751769,439944,1311825,3.942,15.697,263064,2.357,31.394,588,1158,199748
1986,f) 500 to 999,6697,67963,4042691,4021569,6717,10.096,3850,5.787,626277,187856,438421,4.671,15.573,582984,138109,444875,3.434,14.496,43293,1.077,28.993,26,196,33555
1986,g) 1000 to 2499,4355,85575,5567745,5494053,8584,10.245,5015,5.985,810881,286412,524469,5.213,14.759,658672,147226,511446,2.680,11.989,152209,2.770,23.978,8,8,20237
1986,h) 2500 to 4999,1727,64204,3970158,3932766,6002,9.490,4089,6.465,561035,181229,379806,4.608,14.266,487051,101434,385617,2.579,12.384,73984,1.881,24.769,0,0,0
1986,i) 5000 to 9999,1036,77274,4252331,4227300,6376,8.296,5533,7.200,558587,166768,391819,3.945,13.214,508018,136816,371202,3.236,12.018,50569,1.196,24.035,D,D,D
1986,j) 10000+,1071,295646,20458949,20380277,22579,7.679,19347,6.580,2416564,756051,1660513,3.710,11.857,2260592,580986,1679606,2.851,11.092,155972,0.765,22.184,0,0,0
1987,a) 1 to 4,2459156,2466879,6005865,5857051,545699,22.466,469929,19.347,2173541,1450859,722682,24.771,37.110,1874283,1234131,640152,21.071,32.000,299258,5.109,64.001,378452,380321,1021860
1987,b) 5 to 9,829947,851118,5964220,5865668,49231,5.798,45255,5.330,1423185,570797,852388,9.731,24.263,1227019,519552,707467,8.858,20.919,196166,3.344,41.837,32926,34354,436433
1987,c) 10 to 19,486021,527535,6936503,6841215,26882,5.103,25321,4.807,1495822,518143,977679,7.574,21.865,1306104,487886,818218,7.132,19.092,189718,2.773,38.183,14887,16184,400185
1987,d) 20 to 99,390738,538055,15992161,15745776,33278,6.231,25357,4.748,3182772,984621,2198151,6.253,20.213,2690950,852747,1838203,5.416,17.090,491822,3.124,34.180,8784,10985,638887
1987,e) 100 to 499,61839,223821,12109504,11906302,21794,9.905,14202,6.455,2429304,835020,1594284,7.013,20.404,2027764,525036,1502728,4.410,17.031,401540,3.372,34.062,735,1645,252229
1987,f) 500 to 999,7180,70770,4314260,4251278,6951,9.993,4525,6.505,790385,313776,476609,7.381,18.592,662700,170178,492522,4.003,15.588,127685,3.003,31.177,27,244,36943
1987,g) 1000 to 2499,4500,85836,5794102,5780522,9560,11.356,6255,7.430,915360,387604,527756,6.705,15.835,887219,214781,672438,3.716,15.348,28141,0.487,30.697,9,273,24588
1987,h) 2500 to 4999,1818,72174,4175672,4169178,7358,10.369,4930,6.948,628991,223920,405071,5.371,15.087,616094,176118,439976,4.224,14.777,12897,0.309,29.555,D,D,D
1987,i) 5000 to 9999,1131,81841,4449138,4508231,8607,10.681,6097,7.566,640522,240568,399954,5.336,14.208,757667,190017,567650,4.215,16.806,-117145,-2.598,28.416,0,0,0
1987,j) 10000+,1108,306143,20115427,20266999,30310,9.976,25657,8.445,2634195,970145,1664050,4.787,12.997,2930594,893580,2037014,4.409,14.460,-296399,-1.462,25.995,0,0,0
1988,a) 1 to 4,2492486,2499754,6075465,5936269,539072,21.897,463287,18.819,2150000,1425143,724857,24.007,36.218,1869407,1191782,677625,20.076,31.491,280593,4.727,62.983,371674,373650,984973
1988,b) 5 to 9,849490,870224,6094719,6000822,46314,5.345,38731,4.470,1391524,544470,847054,9.073,23.189,1203948,474422,729526,7.906,20.063,187576,3.126,40.126,30780,32412,408279
1988,c) 10 to 19,500318,544002,7153464,7041546,23916,4.412,20035,3.696,1455584,483594,971990,6.868,20.671,1232504,434236,798268,6.167,17.503,223080,3.168,35.007,13970,15714,376050
1988,d) 20 to 99,402934,557348,16472103,16216339,32057,5.802,22474,4.067,3057992,890190,2167802,5.489,18.857,2545623,782684,1762939,4.827,15.698,512369,3.160,31.396,8133,10920,595540
1988,e) 100 to 499,64264,237745,12420907,12237826,24694,10.603,14995,6.439,2298940,742784,1556156,6.070,18.786,1930741,558389,1372352,4.563,15.777,368199,3.009,31.554,780,2167,277995
1988,f) 500 to 999,7538,75399,4513986,4450270,8454,11.447,5359,7.256,774851,267878,506973,6.019,17.411,650489,195111,455378,4.384,14.617,124362,2.794,29.234,36,197,49706
1988,g) 1000 to 2499,4765,92448,6118978,5985992,11717,13.053,6346,7.070,1006815,390501,616314,6.524,16.820,737895,249115,488780,4.162,12.327,268920,4.492,24.654,18,153,51593
1988,h) 2500 to 4999,1841,76616,4289470,4224099,8466,11.180,6685,8.828,674764,282310,392454,6.683,15.974,542914,192579,350335,4.559,12.853,131850,3.121,25.706,3,119,20790
1988,i) 5000 to 9999,1093,78807,4614137,4603568,8492,10.869,7142,9.141,715986,261048,454938,5.671,15.553,695747,232642,463105,5.054,15.113,20239,0.440,30.226,D,D,D
1988,j) 10000+,986,326116,20629515,20496686,35410,11.005,26722,8.305,2845383,953820,1891563,4.654,13.882,2587258,786233,1801025,3.836,12.623,258125,1.259,25.246,0,0,0
1989,a) 1 to 4,2518602,2526959,6126132,5987724,529755,21.264,458452,18.402,2135364,1406903,728461,23.496,35.662,1856950,1186911,670039,19.822,31.013,278414,4.650,62.025,373208,375377,995652
1989,b) 5 to 9,865757,887827,6214051,6109029,45264,5.114,39747,4.491,1416153,549122,867031,8.989,23.181,1206920,489808,717112,8.018,19.756,209233,3.425,39.513,32375,34395,430151
1989,c) 10 to 19,512358,557688,7330123,7200521,22355,4.016,20203,3.630,1470171,474358,995813,6.588,20.418,1210736,442141,768595,6.140,16.815,259435,3.603,33.629,14366,16810,387987
1989,d) 20 to 99,415624,572103,16997782,16656123,30045,5.286,22720,3.997,3119987,888536,2231451,5.335,18.732,2437229,831873,1605356,4.994,14.633,682758,4.099,29.265,8821,12268,640138
1989,e) 100 to 499,66783,245284,12955867,12669614,21891,9.042,15525,6.413,2269466,651218,1618248,5.140,17.913,1694784,525449,1169335,4.147,13.377,574682,4.536,26.754,697,2465,233890
1989,f) 500 to 999,7759,79086,4653741,4559300,8338,10.768,5027,6.492,720173,230221,489952,5.049,15.796,529135,156830,372305,3.440,11.606,191038,4.190,23.211,24,287,33479
1989,g) 1000 to 2499,5054,97702,6432909,6296531,10703,11.211,6236,6.532,943016,302894,640122,4.810,14.977,674279,207388,466891,3.294,10.709,268737,4.268,21.417,17,149,46456
1989,h) 2500 to 4999,1944,82310,4621777,4537278,8118,10.028,5405,6.677,680116,243140,436976,5.359,14.990,511568,162678,348890,3.585,11.275,168548,3.715,22.550,3,3,18150
1989,i) 5000 to 9999,1121,84370,4760824,4712145,6919,8.227,6374,7.579,685876,226698,459178,4.811,14.555,583657,181061,402596,3.842,12.386,102219,2.169,24.772,0,0,0
1989,j) 10000+,1050,337829,21238361,21139632,40057,11.979,33194,9.927,2825750,964324,1861426,4.562,13.367,2656521,802095,1854426,3.794,12.567,169229,0.801,25.133,0,0,0
1990,a) 1 to 4,2540665,2549149,6181515,6052476,523994,20.813,460948,18.309,2130016,1393881,736135,23.030,35.192,1871744,1192454,679290,19.702,30.925,258272,4.267,61.851,377086,379756,1007727
1990,b) 5 to 9,880807,903706,6288031,6214562,43730,4.848,40265,4.464,1396249,528372,867877,8.502,22.467,1250214,494048,756166,7.950,20.117,146035,2.350,40.235,32865,35057,436227
1990,c) 10 to 19,523698,568872,7448091,7359620,21759,3.831,19942,3.511,1449757,463029,986728,6.291,19.699,1273542,448009,825533,6.087,17.304,176215,2.394,34.609,14845,16938,399455
1990,d) 20 to 99,428328,585753,17330374,17114406,28206,4.847,20665,3.551,2961836,852037,2109799,4.978,17.306,2531354,752633,1778721,4.398,14.791,430482,2.515,29.582,8373,11167,601016
1990,e) 100 to 499,69015,254169,13249283,13096531,20310,8.083,14504,5.772,2067035,611445,1455590,4.669,15.783,1762525,478503,1284022,3.654,13.458,304510,2.325,26.916,708,1912,237554
1990,f) 500 to 999,7976,83171,4796885,4723156,9309,11.477,5189,6.397,692000,213767,478233,4.526,14.651,543638,132839,410799,2.813,11.510,148362,3.141,23.020,15,41,20216
1990,g) 1000 to 2499,5113,103243,6609474,6544146,9444,9.285,6385,6.277,850531,284363,566168,4.345,12.997,720273,173032,547241,2.644,11.006,130258,1.990,22.013,5,5,12215
1990,h) 2500 to 4999,1948,84032,4798022,4724299,8730,10.621,5061,6.157,629404,222506,406898,4.710,13.323,481349,123358,357991,2.611,10.189,148055,3.134,20.378,D,D,D
1990,i) 5000 to 9999,1115,87726,4891178,4808212,6589,7.563,5380,6.175,683884,218077,465807,4.536,14.223,519593,126514,393079,2.631,10.806,164291,3.417,21.613,0,0,0
1990,j) 10000+,1079,350277,22077605,21948595,28814,8.276,24552,7.052,2647632,784927,1862705,3.576,12.063,2384964,643464,1741500,2.932,10.866,262668,1.197,21.732,0,0,0
1991,a) 1 to 4,2527081,2536228,6020097,6073734,481128,18.961,483553,19.057,1916839,1254024,662815,20.647,31.559,2025775,1256734,769041,20.691,33.353,-108936,-1.794,63.119,389592,392267,1048013
1991,b) 5 to 9,883720,908881,6161573,6235221,44934,4.951,42414,4.673,1258193,506358,751835,8.121,20.179,1404105,528211,875894,8.471,22.519,-145912,-2.340,40.358,34740,36498,462923
1991,c) 10 to 19,524583,576729,7240080,7344432,30582,5.340,22467,3.923,1311793,494687,817106,6.736,17.861,1520343,514474,1005869,7.005,20.701,-208550,-2.840,35.722,16717,18871,455954
1991,d) 20 to 99,419853,596149,16496165,16830646,45652,7.764,29310,4.985,2733870,985632,1748238,5.856,16.243,3402773,1078124,2324649,6.406,20.218,-668903,-3.974,32.487,11572,15356,858995
1991,e) 100 to 499,67019,261572,12614368,12831175,23925,9.275,16706,6.476,1834586,647484,1187102,5.046,14.298,2270923,663726,1607197,5.173,17.698,-436337,-3.401,28.596,1127,3234,385082
1991,f) 500 to 999,7923,81767,4650388,4703944,8091,10.010,6209,7.682,601625,204184,397441,4.341,12.790,709790,206880,502910,4.398,15.089,-108165,-2.299,25.580,52,319,70774
1991,g) 1000 to 2499,5162,106821,6574536,6608032,10475,9.936,7686,7.290,790425,288559,501866,4.367,11.962,859611,250679,608932,3.794,13.009,-69186,-1.047,23.923,21,51,59276
1991,h) 2500 to 4999,1968,83206,4677211,4699263,8886,10.892,5644,6.918,549110,204916,344194,4.361,11.685,593840,169421,424419,3.605,12.637,-44730,-0.952,23.370,D,D,D
1991,i) 5000 to 9999,1168,90168,4850251,4884891,6201,6.872,6345,7.031,541136,169029,372107,3.460,11.078,607606,164458,443148,3.367,12.438,-66470,-1.361,22.155,0,0,0
1991,j) 10000+,1012,364190,22162647,22354464,30758,8.473,28397,7.823,2450154,864237,1585917,3.866,10.960,2841162,663523,2177639,2.968,12.710,-391008,-1.749,21.921,D,D,D
1992,a) 1 to 4,2547102,2552817,6084997,6063165,475863,18.698,460086,18.079,1934704,1229268,705436,20.274,31.909,1892097,1161858,730239,19.163,31.206,42607,0.703,62.413,363232,365941,951236
1992,b) 5 to 9,877808,898215,6183023,6171600,42464,4.723,44055,4.900,1290487,470806,819681,7.629,20.910,1267632,480810,786822,7.791,20.540,22855,0.370,41.080,30145,32022,399769
1992,c) 10 to 19,515802,566296,7227499,7234678,24991,4.409,25951,4.579,1372411,434157,938254,6.001,18.970,1387644,459623,928021,6.353,19.180,-15233,-0.211,37.940,13519,15124,365452
1992,d) 20 to 99,410564,599276,16437683,16349066,31466,5.275,25832,4.331,2849450,793064,2056386,4.851,17.429,2673037,761928,1911109,4.660,16.350,176413,1.079,32.700,7721,10720,561744
1992,e) 100 to 499,65529,271128,12634971,12551529,19201,7.125,15949,5.918,1990815,561886,1428929,4.477,15.861,1823813,489890,1333923,3.903,14.531,167002,1.331,29.061,689,2198,236291
1992,f) 500 to 999,7778,82021,4600454,4565237,8055,9.975,5510,6.824,662447,228183,434264,4.998,14.511,593335,151838,441497,3.326,12.997,69112,1.514,25.994,28,422,37321
1992,g) 1000 to 2499,5126,110233,6655008,6627869,9345,8.508,8561,7.794,868636,263092,605544,3.969,13.106,812930,254221,558709,3.836,12.265,55706,0.840,24.531,14,109,49203
1992,h) 2500 to 4999,2000,81229,4771428,4755325,7042,8.658,7254,8.919,607477,174571,432906,3.671,12.775,574742,177184,397558,3.726,12.086,32735,0.688,24.173,3,3,21480
1992,i) 5000 to 9999,1132,94984,5031941,5033603,6248,6.573,6385,6.717,634750,209421,425329,4.160,12.610,637807,181441,456366,3.605,12.671,-3057,-0.061,25.221,D,D,D
1992,j) 10000+,926,359040,21806736,22071583,24473,6.723,34377,9.444,2475511,764035,1711476,3.462,11.216,2998147,1000695,1997452,4.534,13.584,-522636,-2.368,22.432,D,D,D
1993,a) 1 to 4,2601158,2606643,6236002,6092681,502888,19.595,422517,16.463,2031705,1293292,738413,21.227,33.347,1743518,1060243,683275,17.402,28.617,288187,4.730,57.233,339848,341461,884643
1993,b) 5 to 9,887632,906161,6290573,6213684,38279,4.234,33958,3.756,1313335,463008,850327,7.451,21.136,1159218,411152,748066,6.617,18.656,154117,2.480,37.312,27219,28799,360371
1993,c) 10 to 19,520190,570927,7347452,7258619,19363,3.394,18408,3.227,1372557,410304,962253,5.653,18.909,1195983,379180,816803,5.224,16.477,176574,2.433,32.953,12085,13828,325780
1993,d) 20 to 99,415738,603528,16725983,16510196,22728,3.764,23475,3.887,2781309,700849,2080460,4.245,16.846,2350495,644058,1706437,3.901,14.237,430814,2.609,28.473,6594,9890,480000
1993,e) 100 to 499,67364,272474,13063604,12844932,16135,5.887,19347,7.059,2088342,500980,1587362,3.900,16.258,1652790,454167,1198623,3.536,12.867,435552,3.391,25.735,550,2750,189710
1993,f) 500 to 999,7804,80331,4665869,4602949,5842,7.273,5831,7.259,677050,178273,498777,3.873,14.709,551440,163778,387662,3.558,11.980,125610,2.729,23.960,23,289,30872
1993,g) 1000 to 2499,5112,109785,6696155,6643064,8474,7.755,7450,6.818,849068,229566,619502,3.456,12.781,740023,217860,522163,3.280,11.140,109045,1.641,22.280,14,75,37886
1993,h) 2500 to 4999,2002,86586,5004851,4969807,6154,7.048,7623,8.730,597078,160389,436689,3.227,12.014,527753,160863,366890,3.237,10.619,69325,1.395,21.238,D,D,D
1993,i) 5000 to 9999,1148,89975,5021562,4985362,5485,6.088,5734,6.364,610661,182513,428148,3.661,12.249,536790,143951,392839,2.887,10.767,73871,1.482,21.535,0,0,0
1993,j) 10000+,1079,355298,22043890,22157244,24604,6.792,38506,10.630,2610014,739888,1870126,3.339,11.780,2849751,828168,2021583,3.738,12.861,-239737,-1.082,23.559,0,0,0
1994,a) 1 to 4,2650819,2656739,6303400,6204631,508363,19.407,433744,16.559,2035930,1296529,739401,20.896,32.813,1839204,1094870,744334,17.646,29.642,196726,3.171,59.285,349807,351727,913846
1994,b) 5 to 9,899288,918424,6369979,6314431,39045,4.257,36547,3.985,1318619,470506,848113,7.451,20.883,1207091,431967,775124,6.841,19.116,111528,1.766,38.233,28342,30391,376491
1994,c) 10 to 19,527942,576496,7473198,7392630,21091,3.662,19983,3.470,1383068,421663,961405,5.704,18.709,1222159,399345,822814,5.402,16.532,160909,2.177,33.064,12714,14856,342866
1994,d) 20 to 99,425177,612113,17286581,17004791,25794,4.230,21188,3.475,2858250,781287,2076963,4.595,16.808,2294890,667750,1627140,3.927,13.496,563360,3.313,26.991,7288,11168,531537
1994,e) 100 to 499,69336,276636,13523114,13244275,18164,6.623,13444,4.902,2099450,546032,1553418,4.123,15.852,1542894,431076,1111818,3.255,11.650,556556,4.202,23.299,636,2067,213238
1994,f) 500 to 999,8084,82617,4858215,4769447,7687,9.424,5582,6.844,684311,205820,478491,4.315,14.348,507273,141663,365610,2.970,10.636,177038,3.712,21.272,31,256,40422
1994,g) 1000 to 2499,5391,111914,6889822,6787565,10439,9.451,7514,6.803,906702,276528,630174,4.074,13.358,701739,196775,504964,2.899,10.339,204963,3.020,20.677,15,272,39661
1994,h) 2500 to 4999,2131,90387,5153044,5103515,8867,10.013,5211,5.884,600641,185201,415440,3.629,11.769,503216,163420,339796,3.202,9.860,97425,1.909,19.720,3,3,17991
1994,i) 5000 to 9999,1235,92317,5243916,5177296,8798,9.685,5855,6.445,675273,240331,434942,4.642,13.043,539944,130873,409071,2.528,10.429,135329,2.614,20.858,0,0,0
1994,j) 10000+,1212,372070,22536498,22533934,32691,8.799,31622,8.511,2720342,933231,1787111,4.141,12.072,2708734,874242,1834492,3.880,12.021,11608,0.052,24.041,0,0,0
1995,a) 1 to 4,2714245,2720244,6447879,6277629,528306,19.771,432051,16.169,2109996,1347877,762119,21.471,33.611,1767250,1080480,686770,17.212,28.152,342746,5.460,56.303,349940,351887,906353
1995,b) 5 to 9,906784,925999,6469070,6352904,39642,4.292,34919,3.781,1354380,485023,869357,7.635,21.319,1122687,420843,701844,6.624,17.672,231693,3.647,35.344,28022,30003,371828
1995,c) 10 to 19,536550,583737,7652632,7495046,20714,3.554,18857,3.236,1432677,433623,999054,5.785,19.115,1117220,389451,727769,5.196,14.906,315457,4.209,29.812,12590,14883,340956
1995,d) 20 to 99,439446,626525,17952340,17538309,26031,4.173,20514,3.289,2983620,788984,2194636,4.499,17.012,2154147,672871,1481276,3.837,12.283,829473,4.729,24.565,7398,11897,551754
1995,e) 100 to 499,72515,280904,14058552,13751247,19196,6.911,12873,4.635,2184213,589098,1595115,4.284,15.884,1571258,434046,1137212,3.156,11.426,612955,4.457,22.853,631,2098,219224
1995,f) 500 to 999,8226,88293,5014559,4904679,7952,9.157,5048,5.813,737865,233467,504398,4.760,15.044,517798,134338,383460,2.739,10.557,220067,4.487,21.114,30,472,41209
1995,g) 1000 to 2499,5406,114651,6975296,6842952,11867,10.549,7549,6.711,932886,318912,613974,4.660,13.633,668663,184334,484329,2.694,9.772,264223,3.861,19.543,10,416,28898
1995,h) 2500 to 4999,2280,95476,5623749,5505752,10440,11.227,5476,5.889,747019,248423,498596,4.512,13.568,509007,125658,383349,2.282,9.245,238012,4.323,18.490,D,D,D
1995,i) 5000 to 9999,1336,93472,5235297,5169439,10311,11.297,5911,6.476,713867,267706,446161,5.179,13.809,581599,152838,428761,2.957,11.251,132268,2.559,22.501,0,0,0
1995,j) 10000+,1176,391038,23581345,23434961,31896,8.161,31509,8.062,2837945,970993,1866952,4.143,12.110,2540088,717333,1822755,3.061,10.839,297857,1.271,21.678,0,0,0
1996,a) 1 to 4,2743294,2749280,6478980,6354143,522582,19.262,450086,16.590,2076830,1333029,743801,20.979,32.685,1825965,1125557,700408,17.714,28.737,250865,3.948,57.473,364928,366893,945286
1996,b) 5 to 9,915438,934363,6496852,6424123,39852,4.273,36616,3.926,1322266,487981,834285,7.596,20.583,1175885,445157,730728,6.929,18.304,146381,2.279,36.608,29434,31378,392800
1996,c) 10 to 19,542424,587771,7658889,7574024,21309,3.631,19506,3.324,1374301,443802,930499,5.860,18.145,1204355,412035,792320,5.440,15.901,169946,2.244,31.802,13335,15389,360458
1996,d) 20 to 99,445148,631094,17950617,17783707,25830,4.107,21417,3.406,2779889,808516,1971373,4.546,15.632,2446314,737163,1709151,4.145,13.756,333575,1.876,27.512,8095,12838,600500
1996,e) 100 to 499,72242,285205,13871709,13748352,19476,6.909,12832,4.552,2000634,587273,1413361,4.272,14.552,1755061,457257,1297804,3.326,12.766,245573,1.786,25.531,734,2373,252239
1996,f) 500 to 999,8373,87868,5048406,4992225,7206,8.258,5982,6.856,715039,218821,496218,4.383,14.323,601442,165331,436111,3.312,12.048,113597,2.275,24.095,36,287,49048
1996,g) 1000 to 2499,5386,112587,6949782,6878375,10746,9.694,7278,6.565,910002,306769,603233,4.460,13.230,769408,197932,571476,2.878,11.186,140594,2.044,22.372,9,42,23486
1996,h) 2500 to 4999,2180,98008,5448752,5396326,9712,10.065,6681,6.924,681646,229368,452278,4.250,12.632,579222,144029,435193,2.669,10.734,102424,1.898,21.467,D,D,D
1996,i) 5000 to 9999,1316,108501,5595883,5526224,10406,9.734,7214,6.748,741742,259427,482315,4.694,13.422,604382,150111,454271,2.716,10.937,137360,2.486,21.873,0,0,0
1996,j) 10000+,1167,403826,24539338,24456410,34965,8.692,31832,7.913,3142225,1097786,2044439,4.489,12.848,2976028,813694,2162334,3.327,12.169,166197,0.680,24.337,0,0,0
1997,a) 1 to 4,2771233,2775532,6548013,6436235,525301,19.126,467249,17.012,2098135,1333771,764364,20.723,32.599,1872480,1179918,692562,18.332,29.093,225655,3.506,58.186,378373,380998,988132
1997,b) 5 to 9,924747,941087,6580512,6507689,42120,4.473,43181,4.586,1361812,496541,865271,7.630,20.926,1217348,492908,724440,7.574,18.706,144464,2.220,37.413,31473,33563,419793
1997,c) 10 to 19,549936,592953,7802633,7707507,24244,4.083,25942,4.369,1461764,452683,1009081,5.873,18.965,1272459,475595,796864,6.171,16.509,189305,2.456,33.019,14558,16835,393287
1997,d) 20 to 99,453921,641732,18539232,18209375,32912,5.142,29578,4.621,3248211,867182,2381029,4.762,17.838,2587213,877284,1709929,4.818,14.208,660998,3.630,28.416,8832,13463,655252
1997,e) 100 to 499,73679,292721,14406722,14123617,23462,8.118,16043,5.551,2457921,667059,1790862,4.723,17.403,1890125,577206,1312919,4.087,13.383,567796,4.020,26.765,889,3086,315626
1997,f) 500 to 999,8412,92172,5211946,5137516,9673,10.686,6362,7.029,820095,263240,556855,5.124,15.963,670696,210802,459894,4.103,13.055,149399,2.908,26.110,56,778,82268
1997,g) 1000 to 2499,5373,118496,7149902,7023207,13493,11.557,10010,8.574,1160774,414370,746404,5.900,16.528,905138,264477,640661,3.766,12.888,255636,3.640,25.776,14,422,37584
1997,h) 2500 to 4999,2160,93202,5502248,5484910,10989,11.909,9140,9.905,814507,287492,527015,5.242,14.850,779287,238416,540871,4.347,14.208,35220,0.642,28.416,3,3,21865
1997,i) 5000 to 9999,1218,103929,5588382,5555561,11719,11.373,9953,9.659,812434,288575,523859,5.194,14.624,748105,216475,531630,3.897,13.466,64329,1.158,26.932,0,0,0
1997,j) 10000+,1005,423480,25764883,25549777,43382,10.229,44634,10.524,3951319,1360130,2591189,5.323,15.465,3505036,1236418,2268618,4.839,13.718,446283,1.747,27.437,0,0,0
1998,a) 1 to 4,2801620,2804818,6595436,6501123,507614,18.292,448239,16.152,2040856,1282639,758217,19.730,31.392,1847837,1119173,728664,17.215,28.423,193019,2.969,56.847,352247,353644,901581
1998,b) 5 to 9,937999,951795,6681715,6618603,36052,3.788,36068,3.789,1330375,460257,870118,6.954,20.101,1203572,438615,764957,6.627,18.185,126803,1.916,36.369,27344,29050,364965
1998,c) 10 to 19,559731,599980,7970405,7879185,17767,2.956,20107,3.345,1425295,417488,1007807,5.299,18.089,1241568,417321,824247,5.296,15.758,183727,2.332,31.515,12737,14733,345183
1998,d) 20 to 99,467543,647847,19180127,18886626,21807,3.358,24986,3.847,3119689,793899,2325790,4.203,16.518,2533013,734384,1798629,3.888,13.412,586676,3.106,26.823,7406,11513,545315
1998,e) 100 to 499,77201,298526,15135577,14836254,21945,7.404,17673,5.963,2475605,652152,1823453,4.396,16.686,1880545,504503,1376042,3.400,12.675,595060,4.011,25.351,701,3868,253106
1998,f) 500 to 999,8874,95594,5423391,5316260,9962,10.613,6500,6.925,875069,253740,621329,4.773,16.460,658226,187580,470646,3.528,12.381,216843,4.079,24.763,37,312,50196
1998,g) 1000 to 2499,5643,122626,7369243,7211995,14214,11.916,7529,6.312,1096694,358886,737808,4.976,15.207,779172,210649,568523,2.921,10.804,317522,4.403,21.608,6,102,14141
1998,h) 2500 to 4999,2307,94156,5780390,5641998,10586,11.502,6344,6.893,838041,278246,559795,4.932,14.854,559372,153821,405551,2.726,9.914,278669,4.939,19.829,0,0,0
1998,i) 5000 to 9999,1370,114722,6103589,5941111,13891,12.378,8897,7.928,985634,317125,668509,5.338,16.590,659055,183957,475098,3.096,11.093,326579,5.497,22.186,0,0,0
1998,j) 10000+,1226,457320,27435597,27188502,48649,10.787,36014,7.985,3771192,1305827,2465365,4.803,13.871,3258598,1001334,2257264,3.683,11.985,512594,1.885,23.970,0,0,0
1999,a) 1 to 4,2809669,2813471,6564035,6500577,495067,17.723,454939,16.286,1995693,1236882,758811,19.027,30.700,1866733,1136794,729939,17.488,28.716,128960,1.984,57.433,356402,357806,910590
1999,b) 5 to 9,942314,956271,6674452,6631497,33219,3.467,37071,3.869,1293403,423803,869600,6.391,19.504,1208121,460706,747415,6.947,18.218,85282,1.286,36.436,28823,30688,383990
1999,c) 10 to 19,566152,604022,8021879,7954495,16185,2.670,20277,3.346,1373995,371883,1002112,4.675,17.273,1238786,444522,794264,5.588,15.573,135209,1.700,31.147,13706,16191,370299
1999,d) 20 to 99,476311,650104,19364184,19151122,21996,3.381,22902,3.520,2900699,694432,2206267,3.626,15.146,2473218,820629,1652589,4.285,12.914,427481,2.232,25.828,8904,14922,667662
1999,e) 100 to 499,79163,302986,15381207,15149082,24094,8.067,15452,5.174,2327321,654532,1672789,4.321,15.363,1864116,528232,1335884,3.487,12.305,463205,3.058,24.610,806,3450,279240
1999,f) 500 to 999,8942,96599,5483251,5417948,10685,11.284,6867,7.252,844588,272407,572181,5.028,15.589,712551,202069,510482,3.730,13.152,132037,2.437,26.303,44,597,55919
1999,g) 1000 to 2499,5671,122096,7539181,7433789,12439,10.345,8724,7.256,1072412,354817,717595,4.773,14.426,855833,247740,608093,3.333,11.513,216579,2.913,23.025,19,352,52367
1999,h) 2500 to 4999,2336,104873,5850063,5754104,13875,13.721,6371,6.300,866732,332475,534257,5.778,15.063,674313,187852,486461,3.265,11.719,192419,3.344,23.438,D,D,D
1999,i) 5000 to 9999,1371,116937,6251098,6142519,16230,14.293,9467,8.337,1035869,444865,591004,7.242,16.864,816123,219616,596507,3.575,13.286,219746,3.577,26.573,0,0,0
1999,j) 10000+,1224,478727,28668470,28675046,47586,9.899,51515,10.717,3963059,1313031,2650028,4.579,13.821,3986197,1385970,2600227,4.833,13.901,-23138,-0.081,27.641,0,0,0
2000,a) 1 to 4,2800852,2805180,6578606,6498300,482066,17.253,459912,16.460,2001164,1231930,769234,18.958,30.795,1837281,1142274,695007,17.578,28.273,163883,2.522,56.547,355260,356964,901466
2000,b) 5 to 9,947006,961158,6750474,6664853,35315,3.672,36618,3.807,1348443,450405,898038,6.758,20.232,1177463,452687,724776,6.792,17.667,170980,2.565,35.334,27887,29759,371953
2000,c) 10 to 19,575739,612216,8209270,8131293,17484,2.851,19540,3.186,1452312,401525,1050787,4.938,17.861,1295448,427903,867545,5.262,15.932,156864,1.929,31.863,13068,15512,354444
2000,d) 20 to 99,487446,654567,19968003,19593881,21803,3.334,20565,3.145,3092382,734507,2357875,3.749,15.782,2342668,746002,1596666,3.807,11.956,749714,3.826,23.912,8108,13419,595773
2000,e) 100 to 499,81619,306599,15960870,15575547,22213,7.324,15592,5.141,2516455,638209,1878246,4.098,16.156,1744736,479598,1265138,3.079,11.202,771719,4.955,22.404,697,3780,253961
2000,f) 500 to 999,9299,99215,5735802,5603239,10475,10.781,6362,6.548,905423,272732,632691,4.867,16.159,637028,186803,450225,3.334,11.369,268395,4.790,22.738,41,605,53105
2000,g) 1000 to 2499,5890,127959,7720288,7550662,14487,11.605,8245,6.605,1164242,396405,767837,5.250,15.419,823191,221898,601293,2.939,10.902,341051,4.517,21.804,9,239,31201
2000,h) 2500 to 4999,2427,102612,6045892,5934668,11381,11.321,7212,7.174,892851,312159,580692,5.260,15.045,669285,174107,495178,2.934,11.278,223566,3.767,22.555,D,D,D
2000,i) 5000 to 9999,1482,123748,6317883,6239288,14456,11.919,9531,7.858,981837,317593,664244,5.090,15.736,822188,237097,585091,3.800,13.178,159649,2.559,26.355,D,D,D
2000,j) 10000+,1295,508052,30293909,30062170,51149,10.126,45295,8.967,4318048,1403316,2914732,4.668,14.364,3873495,1297143,2576352,4.315,12.885,444553,1.479,25.770,0,0,0
2001,a) 1 to 4,2803709,2809409,6522376,6505144,486422,17.382,464441,16.597,1935319,1232339,702980,18.944,29.751,1899508,1159188,740320,17.820,29.200,35811,0.551,58.400,356855,358720,910453
2001,b) 5 to 9,945337,960418,6660426,6664280,35383,3.680,37514,3.902,1245262,440443,804819,6.609,18.686,1253176,467180,785996,7.010,18.804,-7914,-0.119,37.371,28571,30546,381205
2001,c) 10 to 19,578184,614114,8145770,8127502,18407,2.995,19563,3.183,1335568,401324,934244,4.938,16.433,1299634,436580,863054,5.372,15.991,35934,0.442,31.981,13361,15585,361347
2001,d) 20 to 99,493975,658161,19994811,19886049,25247,3.848,21253,3.239,2869196,756200,2112996,3.803,14.428,2652459,794447,1858012,3.995,13.338,216737,1.090,26.677,8579,13301,640566
2001,e) 100 to 499,82769,311698,15942805,15864143,22537,7.286,17778,5.747,2244079,606037,1638042,3.820,14.146,2086357,587860,1498497,3.706,13.151,157722,0.994,26.303,837,3340,305114
2001,f) 500 to 999,9457,100790,5825376,5788683,9123,9.122,7559,7.558,841196,248338,592858,4.290,14.532,768710,225899,542811,3.902,13.280,72486,1.252,26.559,49,1410,69748
2001,g) 1000 to 2499,5860,130312,7742732,7724797,15152,11.735,12757,9.880,1099503,364224,735279,4.715,14.233,1060257,347769,712488,4.502,13.725,39246,0.508,27.451,29,2507,86146
2001,h) 2500 to 4999,2414,103369,6064778,6038952,13362,13.053,11357,11.094,913786,310771,603015,5.146,15.132,862992,325538,537454,5.391,14.290,50794,0.841,28.581,7,356,48239
2001,i) 5000 to 9999,1366,118668,6403961,6438329,14249,12.085,12725,10.792,959597,383327,576270,5.954,14.904,1020184,352073,668111,5.468,15.845,-60587,-0.941,29.809,D,D,D
2001,j) 10000+,1199,525877,30466096,30613780,54296,10.303,56478,10.718,4323153,1578102,2745051,5.155,14.122,4625606,1625364,3000242,5.309,15.110,-302453,-0.988,28.243,0,0,0
2002,a) 1 to 4,2826690,2830628,6646017,6612832,508274,17.991,497415,17.606,2059292,1303104,756188,19.706,31.141,1992201,1232148,760053,18.633,30.126,67091,1.015,60.253,363620,365741,936180
2002,b) 5 to 9,951520,965127,6710322,6721665,46303,4.802,44688,4.634,1358666,535479,823187,7.966,20.213,1380925,526974,853952,7.840,20.544,-22259,-0.331,40.426,31861,33481,427329
2002,c) 10 to 19,582481,618964,8176837,8193060,32059,5.200,27163,4.406,1510547,571772,938775,6.979,18.437,1541446,543941,997505,6.639,18.814,-30899,-0.377,36.874,16161,17853,438824
2002,d) 20 to 99,490007,664312,19648810,19831155,45631,6.942,31594,4.807,3320336,1302256,2018080,6.567,16.743,3682311,1152710,2529601,5.813,18.568,-361975,-1.825,33.486,11405,15393,880263
2002,e) 100 to 499,81194,318994,15462967,15676361,24208,7.664,17991,5.695,2365713,861147,1504566,5.493,15.091,2793253,734126,2059127,4.683,17.818,-427540,-2.727,30.182,1230,3877,431878
2002,f) 500 to 999,9456,104109,5659038,5755239,10128,9.839,7795,7.572,812293,280769,531524,4.878,14.114,1003810,282315,721495,4.905,17.442,-191517,-3.328,28.228,78,1255,104682
2002,g) 1000 to 2499,5952,127376,7515931,7634358,11146,8.754,11055,8.682,1071667,377020,694647,4.938,14.037,1306336,394426,911910,5.166,17.111,-234669,-3.074,28.075,35,1154,102297
2002,h) 2500 to 4999,2433,101764,5896695,5969536,10428,10.277,9843,9.700,842227,291948,550279,4.891,14.109,988968,293635,695333,4.919,16.567,-146741,-2.458,28.218,6,695,43239
2002,i) 5000 to 9999,1403,120399,6193835,6317316,12370,10.319,11332,9.453,906148,337790,568358,5.347,14.344,1144033,316182,827851,5.005,18.109,-237885,-3.766,28.688,D,D,D
2002,j) 10000+,1246,540820,29896054,30442762,58399,10.802,58010,10.730,4291118,1601776,2689342,5.262,14.096,5410957,1670328,3740629,5.487,17.774,-1119839,-3.679,28.191,D,D,D
2003,a) 1 to 4,2871624,2875226,6735749,6634189,537634,18.907,474383,16.682,2097225,1347245,749980,20.308,31.612,1889275,1153596,735679,17.389,28.478,207950,3.135,56.956,366937,368383,929847
2003,b) 5 to 9,954523,966770,6751460,6690998,38870,4.028,35487,3.677,1341069,483682,857387,7.229,20.043,1220255,436448,783807,6.523,18.237,120814,1.806,36.475,28481,29887,378261
2003,c) 10 to 19,584751,620632,8250845,8173194,20903,3.371,19870,3.204,1453586,447979,1005607,5.481,17.785,1297757,410123,887634,5.018,15.878,155829,1.907,31.756,12872,14558,347249
2003,d) 20 to 99,491739,666032,19889702,19629416,25945,3.899,24715,3.714,3190561,815271,2375290,4.153,16.254,2669400,734007,1935393,3.739,13.599,521161,2.655,27.198,7460,11124,551654
2003,e) 100 to 499,82987,327282,16059785,15817351,20637,6.325,18581,5.695,2557596,616393,1941203,3.897,16.170,2071247,588394,1482853,3.720,13.095,486349,3.075,26.190,760,2617,266454
2003,f) 500 to 999,9394,104849,5617947,5601841,7304,6.968,7253,6.919,791167,211432,579735,3.774,14.123,757695,211126,546569,3.769,13.526,33472,0.598,27.052,40,354,55584
2003,g) 1000 to 2499,5888,129406,7525652,7515231,11837,9.213,9992,7.777,1033488,334402,699086,4.450,13.752,1004486,305022,699464,4.059,13.366,29002,0.386,26.732,23,1038,69442
2003,h) 2500 to 4999,2405,104576,5876344,5903193,9163,8.763,9131,8.733,760840,226495,534345,3.837,12.889,811404,240846,570558,4.080,13.745,-50564,-0.857,25.777,D,D,D
2003,i) 5000 to 9999,1396,117115,6265390,6301880,11997,10.321,10250,8.818,831889,236942,594947,3.760,13.201,903630,285700,617930,4.534,14.339,-71741,-1.138,26.401,0,0,0
2003,j) 10000+,1525,548287,29506092,29874904,50726,9.212,55474,10.074,3639306,1308057,2331249,4.378,12.182,4401643,1478011,2923632,4.947,14.734,-762337,-2.552,24.364,D,D,D
2004,a) 1 to 4,2927899,2932174,6868477,6725975,559148,19.364,469994,16.276,2145579,1383542,762037,20.570,31.900,1862614,1146859,715755,17.051,27.693,282965,4.207,55.386,364429,365558,924870
2004,b) 5 to 9,969983,983311,6891145,6804026,37942,3.865,34628,3.528,1371620,488561,883059,7.180,20.159,1197817,439948,757869,6.466,17.605,173803,2.554,35.209,28463,29709,379513
2004,c) 10 to 19,593089,629099,8409332,8309572,18388,2.924,17742,2.822,1458848,434295,1024553,5.226,17.556,1258582,408827,849755,4.920,15.146,200266,2.410,30.292,13057,14808,352520
2004,d) 20 to 99,499693,672429,20232803,19999588,19894,2.964,17577,2.618,2950058,784587,2165471,3.923,14.751,2482265,696249,1786016,3.481,12.412,467793,2.339,24.823,7688,11230,570829
2004,e) 100 to 499,84516,330321,16394873,16249345,17968,5.465,14906,4.534,2155330,553467,1601863,3.406,13.264,1865965,507056,1358909,3.120,11.483,289365,1.781,22.967,771,3296,279885
2004,f) 500 to 999,9280,104351,5671120,5616757,6885,6.580,7464,7.133,742752,199040,543712,3.544,13.224,637581,187816,449765,3.344,11.351,105171,1.872,22.703,36,1092,47064
2004,g) 1000 to 2499,5797,132422,7631818,7566227,13222,10.219,7162,5.535,973915,311690,662225,4.119,12.872,843462,241966,601496,3.198,11.148,130453,1.724,22.295,17,21,51163
2004,h) 2500 to 4999,2339,108178,6071144,6073886,10610,9.913,8321,7.774,749560,232701,516859,3.831,12.341,757546,245037,512509,4.034,12.472,-7986,-0.131,24.681,6,722,38330
2004,i) 5000 to 9999,1344,118305,6384329,6372610,12046,10.334,8569,7.351,876192,265329,610863,4.164,13.749,855927,300659,555268,4.718,13.431,20265,0.318,26.863,0,0,0
2004,j) 10000+,1176,557237,29607578,29665470,53621,9.598,56479,10.110,3819265,1186775,2632490,4.001,12.874,3958803,1364253,2594550,4.599,13.345,-139538,-0.470,25.749,0,0,0
2005,a) 1 to 4,2989099,2994110,6894323,6838146,568850,19.246,492064,16.648,2121379,1392480,728899,20.363,31.023,2011106,1195423,815683,17.482,29.410,110273,1.613,58.820,379595,381231,957667
2005,b) 5 to 9,982331,996405,6898689,6895085,40203,4.043,36023,3.623,1339901,512339,827562,7.430,19.433,1331301,453460,877841,6.577,19.308,8600,0.125,38.616,29242,30807,389568
2005,c) 10 to 19,597598,633105,8348470,8363252,20000,3.164,18112,2.865,1395921,465058,930863,5.561,16.691,1424437,416750,1007687,4.983,17.032,-28516,-0.341,33.382,13307,15100,358912
2005,d) 20 to 99,503147,675393,20214640,20136317,22934,3.408,17920,2.663,2880981,824864,2056117,4.096,14.307,2721554,701352,2020202,3.483,13.516,159427,0.792,27.031,7772,11644,571994
2005,e) 100 to 499,85750,334963,16709741,16454805,22225,6.733,12458,3.774,2309121,638422,1670699,3.880,14.033,1801943,443334,1358609,2.694,10.951,507178,3.082,21.902,662,1811,231073
2005,f) 500 to 999,9498,110253,5887251,5783178,10213,9.381,7449,6.842,856452,279015,577437,4.825,14.809,648800,169496,479304,2.931,11.219,207652,3.591,22.437,40,1101,54873
2005,g) 1000 to 2499,5880,126007,7776789,7695016,10914,8.741,8614,6.899,1015197,336763,678434,4.376,13.193,850912,244991,605921,3.184,11.058,164285,2.135,22.116,16,221,47529
2005,h) 2500 to 4999,2334,109299,6178767,6108507,9928,9.196,7256,6.721,793970,248807,545163,4.073,12.998,650348,212428,437920,3.478,10.647,143622,2.351,21.293,3,3,25247
2005,i) 5000 to 9999,1325,121873,6286524,6259885,10104,8.376,7608,6.307,764106,253333,510773,4.047,12.206,712492,207853,504639,3.320,11.382,51614,0.825,22.764,D,D,D
2005,j) 10000+,1198,575853,30241785,30298773,54178,9.415,53333,9.268,3527223,1180135,2347088,3.895,11.641,3637517,1138304,2499213,3.757,12.005,-110294,-0.364,23.283,0,0,0
2006,a) 1 to 4,3051698,3056989,7047662,6919239,601765,19.948,521022,17.272,2203684,1453246,750438,21.003,31.849,1944779,1223560,721219,17.683,28.107,258905,3.742,56.214,410709,412394,1001369
2006,b) 5 to 9,997505,1012416,7107985,6979303,43657,4.331,34805,3.453,1458952,547316,911636,7.842,20.904,1202709,440014,762695,6.305,17.233,256243,3.671,34.465,29027,30311,385784
2006,c) 10 to 19,604779,642565,8592617,8429687,25176,3.942,17483,2.737,1546210,515913,1030297,6.120,18.342,1218753,401384,817369,4.762,14.458,327457,3.885,28.916,12915,14503,347225
2006,d) 20 to 99,509516,692133,20860784,20426823,36469,5.343,17245,2.527,3311777,1033981,2277796,5.062,16.213,2442876,690452,1752424,3.380,11.959,868901,4.254,23.918,7527,10653,558149
2006,e) 100 to 499,87708,346728,17144246,16836257,27833,8.201,13142,3.872,2493703,772152,1721551,4.586,14.812,1876706,445847,1430859,2.648,11.147,616997,3.665,22.294,631,2380,225589
2006,f) 500 to 999,9846,110251,6084866,5980961,9582,8.832,6066,5.591,845761,233067,612694,3.897,14.141,639163,155129,484034,2.594,10.687,206598,3.454,21.373,32,881,46388
2006,g) 1000 to 2499,6009,136577,8044132,7884299,13992,10.493,7533,5.649,1080095,328897,751198,4.172,13.699,760201,191410,568791,2.428,9.642,319894,4.057,19.284,9,171,30019
2006,h) 2500 to 4999,2396,108350,6344986,6273077,9855,9.238,6516,6.108,782331,256213,526118,4.084,12.471,636781,157131,479650,2.505,10.151,145550,2.320,20.302,D,D,D
2006,i) 5000 to 9999,1364,124633,6676355,6559311,14208,11.699,7831,6.448,950707,301525,649182,4.597,14.494,720766,231847,488919,3.535,10.988,229941,3.506,21.977,D,D,D
2006,j) 10000+,1175,609668,31370418,31144005,61731,10.230,49254,8.162,4031560,1391021,2640539,4.466,12.945,3599420,1082481,2516939,3.476,11.557,432140,1.388,23.115,0,0,0
2007,a) 1 to 4,3073942,3078453,6973632,6956697,570494,18.672,524167,17.156,2074300,1358373,715927,19.526,29.817,2045231,1235032,810199,17.753,29.399,29069,0.418,58.799,413780,415513,1009578
2007,b) 5 to 9,1004652,1017915,7048792,7042866,42731,4.201,41113,4.042,1376713,519403,857310,7.375,19.548,1364744,486697,878047,6.910,19.378,11969,0.170,38.755,31016,32321,410595
2007,c) 10 to 19,609208,644051,8523333,8503596,24613,3.827,22919,3.563,1447456,499185,948271,5.870,17.022,1408427,458749,949678,5.395,16.563,39029,0.459,33.125,13813,15342,370447
2007,d) 20 to 99,512850,697983,20639680,20596938,31588,4.549,24500,3.528,3094021,915972,2178049,4.447,15.022,3004783,863992,2140791,4.195,14.588,89238,0.433,29.177,8191,11010,606819
2007,e) 100 to 499,87860,352214,16914636,16889627,23208,6.659,15833,4.543,2258941,577828,1681113,3.421,13.375,2207161,521941,1685220,3.090,13.068,51780,0.307,26.136,724,2770,252907
2007,f) 500 to 999,10077,113832,6128798,6078535,9786,8.747,5890,5.264,824400,224226,600174,3.689,13.562,723789,174674,549115,2.874,11.907,100611,1.655,23.815,35,309,48422
2007,g) 1000 to 2499,6380,141941,8308388,8200221,13367,9.571,8819,6.314,1108247,318925,789322,3.889,13.515,892107,245456,646651,2.993,10.879,216140,2.636,21.758,19,154,51898
2007,h) 2500 to 4999,2549,113179,6526393,6443207,11875,10.703,7422,6.689,869635,249924,619711,3.879,13.497,704535,182209,522326,2.828,10.935,165100,2.562,21.869,D,D,D
2007,i) 5000 to 9999,1456,122271,6745969,6719745,13942,11.512,11611,9.588,888170,302605,585565,4.503,13.217,835244,238034,597210,3.542,12.430,52926,0.788,24.859,D,D,D
2007,j) 10000+,1391,636986,31980329,32131370,67554,10.619,65881,10.356,4338620,1384786,2953834,4.310,13.503,4643970,1487786,3156184,4.630,14.453,-305350,-0.950,27.006,D,D,D
2008,a) 1 to 4,3033318,3037472,6814001,6920472,508045,16.580,561598,18.327,1912058,1215905,696153,17.570,27.629,2124333,1289577,834756,18.634,30.696,-212275,-3.067,55.258,441354,442680,1051459
2008,b) 5 to 9,993575,1006876,6919364,6972145,38074,3.780,38803,3.852,1265828,468712,797116,6.723,18.156,1371111,480085,891026,6.886,19.666,-105283,-1.510,36.311,31483,32822,417809
2008,c) 10 to 19,600955,636731,8367222,8401969,21739,3.417,20683,3.251,1310635,443908,866727,5.283,15.599,1380550,442410,938140,5.266,16.431,-69915,-0.832,31.198,14147,15997,380763
2008,d) 20 to 99,507865,692720,20480811,20436303,26982,3.905,23299,3.372,2873604,800106,2073498,3.915,14.061,2784995,772678,2012317,3.781,13.628,88609,0.434,27.255,8134,11220,598557
2008,e) 100 to 499,87799,353451,17051213,16894763,21502,6.125,16753,4.772,2282974,549121,1733853,3.250,13.513,1971438,506602,1464836,2.999,11.669,311536,1.844,23.338,754,2419,258028
2008,f) 500 to 999,10147,116174,6178038,6133535,8252,7.147,6818,5.905,817120,222592,594528,3.629,13.322,729374,194106,535268,3.165,11.892,87746,1.431,23.783,38,439,49784
2008,g) 1000 to 2499,6288,141717,8306754,8284180,11005,7.785,10296,7.283,1026372,272237,754135,3.286,12.390,982290,262989,719301,3.175,11.857,44082,0.532,23.715,21,597,65022
2008,h) 2500 to 4999,2506,118275,6557209,6515986,10844,9.290,7754,6.643,796402,248165,548237,3.809,12.222,715274,201593,513681,3.094,10.977,81128,1.245,21.954,5,383,31493
2008,i) 5000 to 9999,1441,122893,6921630,6868262,14968,12.436,9894,8.221,915194,325517,589677,4.739,13.325,809983,235497,574486,3.429,11.793,105211,1.532,23.586,D,D,D
2008,j) 10000+,2044,649099,31983744,32213968,49559,7.601,55455,8.505,3764385,1073273,2691112,3.332,11.686,4250297,1203826,3046471,3.737,13.194,-485912,-1.508,23.371,0,0,0
2009,a) 1 to 4,2952556,2957549,6551964,6835128,451808,14.891,604847,19.935,1695847,1065433,630414,15.588,24.811,2263818,1384866,878952,20.261,33.120,-567971,-8.310,49.622,457589,459052,1093215
2009,b) 5 to 9,967489,982049,6617148,6803218,32758,3.328,37358,3.795,1099162,409556,689606,6.020,16.157,1467865,471884,995981,6.936,21.576,-368703,-5.420,32.313,31057,32391,411054
2009,c) 10 to 19,585185,622811,7980580,8200955,17290,2.774,18316,2.938,1096027,370463,725564,4.517,13.365,1535668,419824,1115844,5.119,18.725,-439641,-5.361,26.729,13652,15484,367859
2009,d) 20 to 99,489967,675783,19115109,19745504,20379,3.020,18227,2.701,2112823,646907,1465916,3.276,10.700,3372320,770095,2602225,3.900,17.079,-1259497,-6.379,21.401,8413,12125,645248
2009,e) 100 to 499,84746,353795,15928097,16392666,19635,5.593,14172,4.037,1614031,487879,1126152,2.976,9.846,2540269,534980,2005289,3.264,15.496,-926238,-5.650,19.692,877,2834,314017
2009,f) 500 to 999,9717,118874,5864749,6015818,8263,6.982,7215,6.096,637259,218132,419127,3.626,10.593,937851,194879,742972,3.239,15.590,-300592,-4.997,21.186,49,601,66545
2009,g) 1000 to 2499,6113,145132,7974385,8146208,11936,8.217,12209,8.404,836194,296128,540066,3.635,10.265,1178471,284181,894290,3.489,14.466,-342277,-4.202,20.530,27,1332,69734
2009,h) 2500 to 4999,2423,117931,6264860,6395512,10257,8.769,8320,7.113,624888,216463,408425,3.385,9.771,884087,188093,695994,2.941,13.824,-259199,-4.053,19.541,3,60,19912
2009,i) 5000 to 9999,1358,119803,6531976,6670046,11370,9.549,9912,8.324,697157,258766,438391,3.880,10.452,977908,235840,742068,3.536,14.661,-280751,-4.209,20.904,D,D,D
2009,j) 10000+,1201,646065,30861859,31578923,49387,7.571,61960,9.498,2978834,1003002,1975832,3.176,9.433,4433837,1107193,3326644,3.506,14.040,-1455003,-4.608,18.866,D,D,D
2010,a) 1 to 4,2938326,2944131,6531909,6669294,459528,15.409,535512,17.957,1688579,1068585,619994,16.022,25.319,1962887,1211534,751353,18.166,29.432,-274308,-4.113,50.637,395015,396855,938478
2010,b) 5 to 9,945986,961459,6569150,6606772,38121,3.975,33220,3.464,1179150,466219,712931,7.057,17.848,1253037,411822,841215,6.233,18.966,-73887,-1.118,35.695,26917,28469,356150
2010,c) 10 to 19,574872,614159,7906975,8010930,15696,2.555,16260,2.646,1091172,333523,757649,4.163,13.621,1297556,363366,934190,4.536,16.197,-206384,-2.576,27.242,11779,13462,316430
2010,d) 20 to 99,468670,659613,18462300,18686689,23878,3.641,16124,2.459,2126483,730757,1395726,3.911,11.380,2574801,570881,2003920,3.055,13.779,-448318,-2.399,22.759,6415,10025,462822
2010,e) 100 to 499,81383,355294,15606251,15641681,22363,6.370,13915,3.964,1790532,575185,1215347,3.677,11.447,1863670,374379,1489291,2.393,11.915,-73138,-0.468,22.894,501,2566,181481
2010,f) 500 to 999,9460,121244,5777760,5802977,7877,6.534,6484,5.379,650045,194756,455289,3.356,11.202,703703,151369,552334,2.608,12.127,-53658,-0.925,22.404,34,318,46506
2010,g) 1000 to 2499,5953,145835,7878410,7951017,10471,7.205,9457,6.507,817572,250856,566716,3.155,10.283,967852,227960,739892,2.867,12.173,-150280,-1.890,20.565,12,636,37880
2010,h) 2500 to 4999,2307,118328,6090158,6171600,8185,6.903,8685,7.324,566063,162322,403741,2.630,9.172,729808,199071,530737,3.226,11.825,-163745,-2.653,18.344,4,339,27075
2010,i) 5000 to 9999,1362,120432,6371018,6414225,11980,10.106,8204,6.921,695273,249977,445296,3.897,10.840,775867,190062,585805,2.963,12.096,-80594,-1.256,21.679,0,0,0
2010,j) 10000+,1183,631338,30117965,30564901,39278,6.124,59263,9.241,2812145,736483,2075662,2.410,9.201,3685581,1029178,2656403,3.367,12.058,-873436,-2.858,18.401,D,D,D
2011,a) 1 to 4,2943356,2949380,6606025,6617083,484412,16.366,505458,17.077,1792372,1128410,663962,17.053,27.087,1814992,1132198,682794,17.110,27.429,-22620,-0.342,54.174,376483,378582,884465
2011,b) 5 to 9,933752,949267,6493031,6535862,33990,3.580,34411,3.624,1150785,420438,730347,6.433,17.607,1235276,424362,810914,6.493,18.900,-84491,-1.293,35.214,27326,28801,359859
2011,c) 10 to 19,567062,607174,7890978,7874555,16897,2.787,15028,2.479,1167658,361825,805833,4.595,14.828,1133857,329167,804690,4.180,14.399,33801,0.429,28.798,10608,12266,284605
2011,d) 20 to 99,461908,654214,18603663,18412039,22595,3.473,15219,2.339,2378834,658270,1720564,3.575,12.920,1994344,543189,1451155,2.950,10.832,384490,2.088,21.663,6013,9229,441814
2011,e) 100 to 499,80932,355659,15769634,15593556,17699,5.013,12477,3.534,1849705,432046,1417659,2.771,11.862,1497683,328027,1169656,2.104,9.604,352022,2.257,19.209,471,1956,159491
2011,f) 500 to 999,9411,122039,5925222,5843657,6273,5.157,5463,4.491,683861,146668,537193,2.510,11.703,520104,106305,413799,1.819,8.900,163757,2.802,17.801,16,192,20032
2011,g) 1000 to 2499,5950,149575,8088250,7998935,9978,6.744,6743,4.557,884514,208753,675761,2.610,11.058,707252,176014,531238,2.200,8.842,177262,2.216,17.684,12,148,31053
2011,h) 2500 to 4999,2273,121183,6233325,6187359,7598,6.282,7144,5.906,630972,150402,480570,2.431,10.198,538300,135684,402616,2.193,8.700,92672,1.498,17.400,D,D,D
2011,i) 5000 to 9999,1284,121021,6478126,6404971,11842,9.946,7926,6.657,742039,213088,528951,3.327,11.585,591546,165523,426023,2.584,9.236,150493,2.350,18.471,D,D,D
2011,j) 10000+,1065,638880,30792361,30637307,48886,7.626,53211,8.301,3456940,844416,2612524,2.756,11.283,3143069,902652,2240417,2.946,10.259,313871,1.024,20.518,D,D,D
2012,a) 1 to 4,2986109,2989976,6714439,6621212,499650,16.846,451722,15.230,1855833,1162318,693515,17.554,28.029,1668272,1030032,638240,15.557,25.196,187561,2.833,50.392,338255,340239,814533
2012,b) 5 to 9,933882,946532,6567445,6514722,32999,3.484,34005,3.591,1164910,407822,757088,6.260,17.881,1059775,389963,669812,5.986,16.267,105135,1.614,32.535,24784,26159,328736
2012,c) 10 to 19,561402,597848,7928773,7813974,19455,3.256,18852,3.155,1263640,408794,854846,5.232,16.172,1033206,351444,681762,4.498,13.223,230434,2.949,26.445,10645,12223,287566
2012,d) 20 to 99,471118,659791,19128885,18793770,24315,3.686,23927,3.628,2763147,761709,2001438,4.053,14.702,2091467,636521,1454946,3.387,11.129,671680,3.574,22.257,6108,9381,442504
2012,e) 100 to 499,81503,352392,16003102,15761188,15962,4.526,16514,4.683,2093994,455529,1638465,2.890,13.286,1613290,410855,1202435,2.607,10.236,480704,3.050,20.472,521,2316,187095
2012,f) 500 to 999,9900,125253,6234226,6128987,6472,5.177,6012,4.809,777498,151132,626366,2.466,12.686,568065,129069,438996,2.106,9.268,209433,3.417,18.537,27,234,37201
2012,g) 1000 to 2499,6128,148686,8243615,8132786,9471,6.407,7761,5.250,960955,211752,749203,2.604,11.816,736721,205007,531714,2.521,9.059,224234,2.757,18.117,14,34,46017
2012,h) 2500 to 4999,2353,122553,6328803,6242834,6640,5.420,6547,5.344,720925,153824,567101,2.464,11.548,545761,128334,417427,2.056,8.742,175164,2.806,17.484,D,D,D
2012,i) 5000 to 9999,1327,121026,6729239,6671764,8670,7.140,9486,7.812,784725,188730,595995,2.829,11.762,671952,213627,458325,3.202,10.072,112773,1.690,20.143,4,2088,56316
2012,j) 10000+,1118,649501,31471862,31441322,46869,7.201,49635,7.626,3363161,804585,2558576,2.559,10.697,3293613,901294,2392319,2.867,10.475,69548,0.221,20.951,0,0,0
2013,a) 1 to 4,2990292,2994066,6679247,6640115,481205,16.139,456509,15.310,1782732,1111423,671309,16.738,26.848,1702458,1048116,654342,15.785,25.639,80274,1.209,51.278,343405,344432,827236
2013,b) 5 to 9,937275,949007,6585422,6530859,32805,3.462,30005,3.166,1129988,404954,725034,6.201,17.302,1020615,370040,650575,5.666,15.628,109373,1.675,31.255,24173,25290,320821
2013,c) 10 to 19,566715,602135,7981145,7888200,19159,3.190,15943,2.655,1212069,394454,817615,5.001,15.366,1024778,336961,687817,4.272,12.991,187291,2.374,25.983,10707,12119,288375
2013,d) 20 to 99,480212,666800,19383510,19169150,22951,3.450,19833,2.981,2512998,677111,1835887,3.532,13.110,2081363,613229,1468134,3.199,10.858,431635,2.252,21.716,6376,8790,467215
2013,e) 100 to 499,83651,354752,16411720,16169503,16426,4.646,14008,3.962,2018218,421997,1596221,2.610,12.482,1532288,415261,1117027,2.568,9.476,485930,3.005,18.953,592,1384,205517
2013,f) 500 to 999,10109,124841,6342821,6269685,6853,5.511,5865,4.717,776248,160584,615664,2.561,12.381,628688,162990,465698,2.600,10.027,147560,2.354,20.055,37,400,51735
2013,g) 1000 to 2499,6338,148282,8259272,8162849,9972,6.754,8712,5.900,967767,234278,733489,2.870,11.856,774402,199628,574774,2.446,9.487,193365,2.369,18.974,14,615,41112
2013,h) 2500 to 4999,2452,132105,6724372,6654620,9106,6.939,7359,5.608,790172,190994,599178,2.870,11.874,650296,167913,482383,2.523,9.772,139876,2.102,19.544,3,58,16365
2013,i) 5000 to 9999,1301,121934,6585803,6513438,10142,8.330,9791,8.041,777008,229857,547151,3.529,11.929,632030,174314,457716,2.676,9.703,144978,2.226,19.407,0,0,0
2013,j) 10000+,1141,659153,32648681,32502343,52159,7.915,51830,7.865,3576148,1075658,2500490,3.309,11.003,3293507,982652,2310855,3.023,10.133,282641,0.870,20.266,0,0,0
2014,a) 1 to 4,3004956,3009255,6718984,6648259,485163,16.216,450251,15.050,1804652,1124300,680352,16.911,27.145,1659445,1026789,632656,15.444,24.961,145207,2.184,49.921,341218,342250,816209
2014,b) 5 to 9,939460,952489,6620553,6552788,31696,3.332,29227,3.072,1132769,395545,737224,6.036,17.287,997956,364873,633083,5.568,15.229,134813,2.057,30.459,23971,25073,317321
2014,c) 10 to 19,574013,609525,8098672,8004476,17313,2.845,15371,2.526,1206098,377772,828326,4.720,15.068,1017366,342047,675319,4.273,12.710,188732,2.358,25.420,10922,12349,292598
2014,d) 20 to 99,489529,677682,19830770,19538971,23729,3.522,16000,2.375,2488469,726371,1762098,3.718,12.736,1903568,571751,1331817,2.926,9.742,584901,2.994,19.485,6152,9370,450590
2014,e) 100 to 499,85759,361148,16847184,16571573,19228,5.383,11317,3.168,1947082,508259,1438823,3.067,11.750,1396675,342361,1054314,2.066,8.428,550407,3.321,16.856,541,1944,186216
2014,f) 500 to 999,10325,124873,6488629,6389811,7589,6.137,5181,4.189,811045,194275,616770,3.040,12.693,612934,125363,487571,1.962,9.592,198111,3.100,19.185,19,213,27596
2014,g) 1000 to 2499,6276,153961,8524549,8377568,12003,7.924,7027,4.639,1020699,266844,753855,3.185,12.184,726274,157130,569144,1.876,8.669,294425,3.514,17.339,5,132,16451
2014,h) 2500 to 4999,2532,133351,6889603,6818886,8516,6.371,9168,6.858,782896,200582,582314,2.942,11.481,639083,149194,489889,2.188,9.372,143813,2.109,18.745,D,D,D
2014,i) 5000 to 9999,1355,127139,6847401,6776366,9428,7.482,7171,5.691,776523,231465,545058,3.416,11.459,634819,164512,470307,2.428,9.368,141704,2.091,18.736,D,D,D
2014,j) 10000+,1149,676718,33256930,33164749,58340,8.671,50504,7.507,3631081,1052754,2578327,3.174,10.949,3453182,1048503,2404679,3.161,10.412,177899,0.536,20.824,0,0,0
2015,a) 1 to 4,3026023,3030718,6757333,6677252,493103,16.395,447023,14.863,1828337,1144808,683529,17.145,27.382,1669764,1033508,636256,15.478,25.007,158573,2.375,50.014,340837,341963,823846
2015,b) 5 to 9,943631,957085,6662356,6588814,32257,3.374,30087,3.147,1148917,402559,746358,6.110,17.437,1002510,378545,623965,5.745,15.215,146407,2.222,30.431,24591,25814,327656
2015,c) 10 to 19,581451,617296,8230538,8114695,18223,2.958,15698,2.548,1242222,398015,844207,4.905,15.308,1011371,359406,651965,4.429,12.463,230851,2.845,24.927,11512,12852,309146
2015,d) 20 to 99,501999,692740,20374323,20044354,25958,3.771,17024,2.473,2609668,791521,1818147,3.949,13.019,1952413,624469,1327944,3.115,9.740,657255,3.279,19.481,6879,10187,498563
2015,e) 100 to 499,87811,367153,17281306,17004648,21400,5.897,12913,3.558,2034382,531800,1502582,3.127,11.964,1480561,354332,1126229,2.084,8.707,553821,3.257,17.414,535,2154,185885
2015,f) 500 to 999,10527,128823,6605976,6506253,8712,6.856,5199,4.092,816547,223420,593127,3.434,12.550,618755,136792,481963,2.102,9.510,197792,3.040,19.020,32,234,42825
2015,g) 1000 to 2499,6466,157332,8785407,8638979,12484,8.047,8110,5.227,1051168,283649,767519,3.283,12.168,758831,167942,590889,1.944,8.784,292337,3.384,17.568,6,451,17216
2015,h) 2500 to 4999,2523,133263,6974210,6875787,8979,6.778,7404,5.589,814800,192374,622426,2.798,11.850,618532,159481,459051,2.319,8.996,196268,2.854,17.992,5,501,32715
2015,i) 5000 to 9999,1354,129627,7008752,6917704,9329,7.271,6697,5.219,789563,224482,565081,3.245,11.414,607642,151668,455974,2.192,8.784,181921,2.630,17.568,0,0,0
2015,j) 10000+,1241,695968,34550343,34314516,58188,8.378,55271,7.958,3954063,1185394,2768669,3.454,11.523,3465195,934788,2530407,2.724,10.098,488868,1.425,20.197,0,0,0
2016,a) 1 to 4,3062987,3067931,6827018,6720619,512731,16.898,445580,14.685,1884168,1194764,689404,17.778,28.036,1670345,1027643,642702,15.291,24.854,213823,3.182,49.708,343361,344496,828821
2016,b) 5 to 9,951752,966020,6739591,6653617,34255,3.553,30524,3.166,1190915,427223,763692,6.421,17.899,1020065,384856,635209,5.784,15.331,170850,2.568,30.662,25321,26443,337561
2016,c) 10 to 19,590358,626573,8361552,8247116,18954,3.032,16237,2.597,1276637,415027,861610,5.032,15.480,1049039,373450,675589,4.528,12.720,227598,2.760,25.440,12010,13400,323556
2016,d) 20 to 99,513461,705282,20767505,20500483,26100,3.725,16743,2.390,2625928,782468,1843460,3.817,12.809,2091260,642875,1448385,3.136,10.201,534668,2.608,20.402,6984,9917,507634
2016,e) 100 to 499,89480,374249,17597346,17358400,20997,5.672,12885,3.481,2030473,529038,1501435,3.048,11.697,1551014,359906,1191108,2.073,8.935,479459,2.762,17.870,569,2435,196577
2016,f) 500 to 999,10645,131537,6709870,6631371,8856,6.821,5444,4.193,815544,198312,617232,2.991,12.298,658944,133887,525057,2.019,9.937,156600,2.362,19.874,29,508,38491
2016,g) 1000 to 2499,6482,158736,8849922,8765259,11793,7.504,8633,5.493,1029563,290953,738610,3.319,11.746,858153,171045,687108,1.951,9.790,171410,1.956,19.581,12,874,33601
2016,h) 2500 to 4999,2563,137695,7135218,7075583,9110,6.674,6740,4.937,776505,200460,576045,2.833,10.974,659820,134963,524857,1.907,9.325,116685,1.649,18.651,D,D,D
2016,i) 5000 to 9999,1406,134943,7202324,7155142,10925,8.240,6209,4.683,796537,229551,566986,3.208,11.132,695971,163287,532684,2.282,9.727,100566,1.406,19.454,D,D,D
2016,j) 10000+,1296,734904,35562624,35389633,58920,8.144,35979,4.973,3640795,1022841,2617954,2.890,10.288,3305996,899787,2406209,2.543,9.342,334799,0.946,18.683,D,D,D
2017,a) 1 to 4,3080170,3084448,6769305,6736006,500770,16.348,458167,14.957,1794867,1146158,648709,17.015,26.646,1728440,1054876,673564,15.660,25.660,66427,0.986,51.319,351525,352849,843738
2017,b) 5 to 9,953672,966030,6726065,6676905,34369,3.560,33210,3.440,1165657,426299,739358,6.385,17.458,1067670,404322,663348,6.056,15.990,97987,1.468,31.981,26061,27234,347935
2017,c) 10 to 19,596559,630686,8429054,8349454,20050,3.179,20228,3.207,1295355,424144,871211,5.080,15.514,1137026,420087,716939,5.031,13.618,158329,1.896,27.236,13098,14835,354909
2017,d) 20 to 99,520827,710523,21077114,20816081,25668,3.616,24213,3.411,2952229,828513,2123716,3.980,14.182,2431654,797275,1634379,3.830,11.682,520575,2.501,23.363,8099,11807,595216
2017,e) 100 to 499,90512,373020,17906114,17626427,18021,4.842,16303,4.381,2478081,523617,1954464,2.971,14.059,1916552,485106,1431446,2.752,10.873,561529,3.186,21.746,653,2274,226531
2017,f) 500 to 999,10941,133391,6876038,6750605,7955,6.006,6056,4.573,922832,207218,715614,3.070,13.670,673262,147821,525441,2.190,9.973,249570,3.697,19.947,26,510,38130
2017,g) 1000 to 2499,6690,161524,9001679,8930265,10940,6.826,8415,5.251,1036214,235890,800324,2.641,11.603,888793,238257,650536,2.668,9.953,147421,1.651,19.905,16,691,51337
2017,h) 2500 to 4999,2667,139656,7128848,7090325,9025,6.468,8762,6.280,795338,185904,609434,2.622,11.217,718121,187028,531093,2.638,10.128,77217,1.089,20.256,6,425,34989
2017,i) 5000 to 9999,1482,137671,7249650,7141064,11883,8.756,7964,5.868,912208,270005,642203,3.781,12.774,694680,182158,512522,2.551,9.728,217528,3.046,19.456,0,0,0
2017,j) 10000+,1345,741398,36323928,36367003,43337,5.790,57493,7.681,3759951,1056414,2703537,2.905,10.339,3854798,1231068,2623730,3.385,10.600,-94847,-0.261,20.678,0,0,0
2018,a) 1 to 4,3093251,3096821,6804703,6737632,499910,16.249,459370,14.931,1819408,1145471,673937,17.001,27.004,1681623,1048428,633195,15.561,24.959,137785,2.045,49.917,355625,356796,844927
2018,b) 5 to 9,957640,969481,6791998,6717735,34631,3.576,32716,3.378,1224350,448544,775806,6.677,18.226,1075274,412976,662298,6.148,16.006,149076,2.219,32.013,26841,27875,358704
2018,c) 10 to 19,601116,634118,8507370,8437451,15896,2.502,18395,2.895,1274310,400758,873552,4.750,15.103,1135051,405269,729782,4.803,13.453,139259,1.650,26.905,12879,14435,346816
2018,d) 20 to 99,525811,707293,21220774,21082875,13971,1.967,19884,2.800,2599108,654930,1944178,3.106,12.328,2324309,694444,1629865,3.294,11.025,274799,1.303,22.049,7298,10672,532082
2018,e) 100 to 499,91667,373204,18134836,17954976,13145,3.525,12550,3.365,2082314,395160,1687154,2.201,11.597,1723026,420032,1302994,2.339,9.596,359288,2.001,19.193,628,3033,219187
2018,f) 500 to 999,10947,136273,7031998,6946936,7638,5.642,5871,4.336,874097,197121,676976,2.838,12.582,704424,139464,564960,2.008,10.140,169673,2.442,20.280,23,797,31093
2018,g) 1000 to 2499,6577,164305,9263676,9153625,11530,7.087,8284,5.092,1067238,271598,795640,2.967,11.659,852975,182770,670205,1.997,9.318,214263,2.341,18.637,13,839,39342
2018,h) 2500 to 4999,2465,136020,7143368,7059835,8232,5.997,10716,7.807,824443,211168,613275,2.991,11.678,654878,173454,481424,2.457,9.276,169565,2.402,18.552,3,150,21093
2018,i) 5000 to 9999,1363,137148,7360029,7310121,9447,6.944,7244,5.325,821917,182774,639143,2.500,11.244,712753,173657,539096,2.376,9.750,109164,1.493,19.500,0,0,0
2018,j) 10000+,1193,745826,37449351,37253666,40568,5.406,49640,6.615,3557675,923625,2634050,2.479,9.550,3163661,878767,2284894,2.359,8.492,394014,1.058,16.984,0,0,0
2019,a) 1 to 4,3129640,3134171,6840900,6787445,516889,16.626,466321,15.000,1825307,1179941,645366,17.384,26.892,1716913,1064383,652530,15.682,25.295,108394,1.597,50.591,368621,369982,874016
2019,b) 5 to 9,958883,971794,6746024,6744970,32783,3.371,34438,3.541,1152102,430723,721379,6.386,17.081,1149771,436351,713420,6.469,17.046,2331,0.035,34.093,28896,30092,384178
2019,c) 10 to 19,606204,639407,8561564,8517409,15557,2.430,17211,2.688,1242057,401909,840148,4.719,14.583,1153812,404761,749051,4.752,13.547,88245,1.036,27.093,13409,14955,360941
2019,d) 20 to 99,531658,706962,21497843,21280488,15917,2.253,14975,2.120,2535586,689444,1846142,3.240,11.915,2102078,617998,1484080,2.904,9.878,433508,2.037,19.756,7351,10064,523932
2019,e) 100 to 499,93215,372815,18426367,18176396,20241,5.492,11778,3.195,2067261,537605,1529656,2.958,11.373,1564045,340309,1223736,1.872,8.605,503216,2.769,17.210,555,1701,192114
2019,f) 500 to 999,11167,137798,7118113,7048897,9234,6.785,5828,4.282,836893,196764,640129,2.791,11.873,701255,144715,556540,2.053,9.948,135638,1.924,19.897,28,569,38676
2019,g) 1000 to 2499,6757,166999,9508272,9383429,11378,6.885,7890,4.774,1058803,275187,783616,2.933,11.284,809158,167419,641739,1.784,8.623,249645,2.660,17.247,6,50,17295
2019,h) 2500 to 4999,2595,142436,7238166,7182043,7475,5.255,7073,4.973,788938,220658,568280,3.072,10.985,674998,167041,507957,2.326,9.398,113940,1.586,18.797,D,D,D
2019,i) 5000 to 9999,1456,136623,7524955,7494031,6680,4.904,5853,4.297,718265,161964,556301,2.161,9.584,663274,142036,521238,1.895,8.851,54991,0.734,17.701,0,0,0
2019,j) 10000+,1283,756266,38467303,38169878,37590,4.971,37479,4.956,3452389,725486,2726903,1.901,9.045,2886732,843672,2043060,2.210,7.563,565657,1.482,15.126,D,D,D
2020,a) 1 to 4,3144808,3150098,6838143,6845685,524479,16.681,512697,16.306,1831039,1186969,644070,17.339,26.747,1844134,1175214,668920,17.167,26.939,-13095,-0.191,53.495,392451,394079,925412
2020,b) 5 to 9,948521,962047,6663756,6683846,32513,3.373,36350,3.771,1126554,423005,703549,6.329,16.855,1166134,462857,703277,6.925,17.447,-39580,-0.592,33.710,29278,30611,392275
2020,c) 10 to 19,603923,636504,8499116,8505471,15700,2.461,18569,2.911,1205311,394695,810616,4.640,14.171,1217767,434153,783614,5.104,14.317,-12456,-0.146,28.342,13960,15729,376035
2020,d) 20 to 99,532474,702616,21444542,21352636,18093,2.579,16079,2.292,2481905,745627,1736278,3.492,11.623,2298338,668269,1630069,3.130,10.764,183567,0.860,21.527,7867,11126,570890
2020,e) 100 to 499,93822,370413,18471184,18338824,17877,4.861,12640,3.437,1892953,450368,1442585,2.456,10.322,1630704,355944,1274760,1.941,8.892,262249,1.430,17.784,589,2170,202425
2020,f) 500 to 999,11336,138230,7197108,7146447,8900,6.504,6106,4.462,859386,209251,650135,2.928,12.025,756231,148770,607461,2.082,10.582,103155,1.443,21.164,26,236,32651
2020,g) 1000 to 2499,6970,172565,9576041,9541247,11358,6.643,8170,4.779,1056947,291617,765330,3.056,11.078,985250,195787,789463,2.052,10.326,71697,0.751,20.652,14,399,36685
2020,h) 2500 to 4999,2614,153850,7414055,7394892,8966,5.839,8390,5.464,767011,186297,580714,2.519,10.372,724403,169934,554469,2.298,9.796,42608,0.576,19.592,3,1147,22293
2020,i) 5000 to 9999,1464,139482,7698568,7682722,11356,8.246,7814,5.674,789745,251415,538330,3.272,10.279,760698,183544,577154,2.389,9.901,29047,0.378,19.803,D,D,D
2020,j) 10000+,1242,750814,38931221,38838336,30821,4.079,40496,5.359,3681864,1026630,2655234,2.643,9.480,3497118,957072,2540046,2.464,9.004,184746,0.476,18.009,0,0,0
2021,a) 1 to 4,3203282,3209453,6977588,6944744,591172,18.556,544060,17.077,2009828,1310200,699628,18.866,28.940,1945395,1224090,721305,17.626,28.012,64433,0.928,56.025,435220,437360,988096
2021,b) 5 to 9,948705,963221,6586815,6682262,31128,3.223,36298,3.758,1122469,398163,724306,5.959,16.798,1312095,458014,854081,6.854,19.635,-189626,-2.838,33.595,28520,30287,379792
2021,c) 10 to 19,601382,635297,8240230,8463502,14931,2.344,18258,2.866,1110711,348381,762330,4.116,13.124,1556290,432536,1123754,5.111,18.388,-445579,-5.265,26.247,13332,15220,358686
2021,d) 20 to 99,516209,684996,19959416,20628301,17982,2.627,17139,2.504,2139595,666823,1472772,3.233,10.372,3479473,682345,2797128,3.308,16.867,-1339878,-6.495,20.744,7486,11552,540814
2021,e) 100 to 499,90521,365151,17209899,17716130,18407,5.062,15383,4.230,1690576,482356,1208220,2.723,9.543,2707077,410643,2296434,2.318,15.280,-1016501,-5.738,19.085,596,4131,226721
2021,f) 500 to 999,11000,139505,6743689,6941054,8007,5.735,8244,5.904,753119,203632,549487,2.934,10.850,1147064,179340,967724,2.584,16.526,-393945,-5.676,21.700,28,1304,39052
2021,g) 1000 to 2499,6683,172934,8927229,9165365,12678,7.286,14819,8.516,967901,274615,693286,2.996,10.560,1445981,248400,1197581,2.710,15.777,-478080,-5.216,21.121,16,1887,49299
2021,h) 2500 to 4999,2598,144258,7002698,7201826,11394,7.932,10158,7.072,742053,245383,496670,3.407,10.304,1142598,224811,917787,3.122,15.865,-400545,-5.562,20.607,D,D,D
2021,i) 5000 to 9999,1445,142755,7370377,7519302,8630,6.001,10729,7.461,774800,222549,552251,2.960,10.304,1072483,245330,827153,3.263,14.263,-297683,-3.959,20.608,3,1822,44171
2021,j) 10000+,1232,735841,37846824,38569062,39855,5.337,61574,8.246,3336473,827474,2508999,2.145,8.651,4762330,1047872,3714458,2.717,12.348,-1425857,-3.697,17.301,0,0,0
