year,fsize,firms,estabs,emp,denom,estabs_entry,estabs_entry_rate,estabs_exit,estabs_exit_rate,job_creation,job_creation_births,job_creation_continuers,job_creation_rate_births,job_creation_rate,job_destruction,job_destruction_deaths,job_destruction_continuers,job_destruction_rate_deaths,job_destruction_rate,net_job_creation,net_job_creation_rate,reallocation_rate,firmdeath_firms,firmdeath_estabs,firmdeath_emp
1978,a) 1 to 4,2161223,2169882,5301413,4961417,489189,23.213,364132,17.279,2051560,1263403,788157,25.465,41.35,1362891,907222,455669,18.286,27.47,688669,13.88,54.94,293872,294765,749033
1978,b) 5 to 9,664229,683541,4942364,4646110,45126,6.69,27134,4.023,1361335,513008,848327,11.042,29.301,771603,320789,450814,6.904,16.608,589732,12.693,33.215,20149,21117,266390
1978,c) 10 to 19,387945,427438,5719571,5406609,23367,5.521,14917,3.525,1383942,429895,954047,7.951,25.597,758503,278663,479840,5.154,14.029,625439,11.568,28.058,8171,9244,218979
1978,d) 20 to 99,304346,429052,12689322,12027223,29358,6.903,21864,5.141,2845551,771285,2074266,6.413,23.659,1522915,554361,968554,4.609,12.662,1322636,10.997,25.324,4648,6217,338708
1978,e) 100 to 499,45450,163199,8968688,8628407,18002,11.069,16882,10.38,1925896,533249,1392647,6.18,22.32,1247259,492535,754724,5.708,14.455,678637,7.865,28.911,391,991,135934
1978,f) 500 to 999,5523,51746,3384055,3296437,6262,12.184,5560,10.818,667367,204921,462446,6.216,20.245,492359,215629,276730,6.541,14.936,175008,5.309,29.872,30,87,42010
1978,g) 1000 to 2499,3364,65689,4295521,4199070,8180,12.466,8035,12.245,774303,264529,509774,6.3,18.44,582145,277558,304587,6.61,13.864,192158,4.576,27.727,13,77,37559
1978,h) 2500 to 4999,1356,54338,3288063,3231103,6257,11.526,6154,11.336,563346,208954,354392,6.467,17.435,449514,205111,244403,6.348,13.912,113832,3.523,27.824,(D),(D),(D)
1978,i) 5000 to 9999,820,48515,3509296,3416960,6303,13.161,5057,10.559,627247,226567,400680,6.631,18.357,442952,174718,268234,5.113,12.963,184295,5.394,25.927,(D),(D),(D)
1978,j) 10000+,694,217226,17311708,16996668,22182,10.324,17467,8.129,2477767,769367,1708400,4.527,14.578,1845052,621460,1223592,3.656,10.855,632715,3.723,21.711,(D),(D),(D)
1979,a) 1 to 4,2187091,2194772,5309322,5097668,481132,22.527,363154,17.003,1951599,1249322,702277,24.508,38.284,1528611,942286,586325,18.485,29.986,422988,8.298,59.973,290433,291525,766547
1979,b) 5 to 9,704058,723910,5142542,4977467,40416,5.614,32372,4.497,1308169,488822,819347,9.821,26.282,980798,384542,596256,7.726,19.705,327371,6.577,39.41,23259,24293,307171
1979,c) 10 to 19,417600,456876,6058365,5867219,18799,4.126,16207,3.557,1321553,389597,931956,6.64,22.524,939031,321676,617355,5.483,16.005,382522,6.52,32.009,9246,10143,246436
1979,d) 20 to 99,332630,460001,13698330,13260913,22102,4.829,17542,3.832,2638575,621805,2016770,4.689,19.897,1761997,537150,1224847,4.051,13.287,876578,6.61,26.574,4744,5833,337769
1979,e) 100 to 499,49672,175610,9752053,9474977,15381,8.863,11251,6.483,1758945,460976,1297969,4.865,18.564,1203863,385213,818650,4.066,12.706,555082,5.858,25.411,320,695,102938
1979,f) 500 to 999,5729,54049,3587917,3497712,5592,10.417,4861,9.055,592139,188083,404056,5.377,16.929,408896,151546,257350,4.333,11.69,183243,5.239,23.381,15,125,16473
1979,g) 1000 to 2499,3441,69247,4560274,4414566,8603,12.694,5656,8.345,749495,267149,482346,6.052,16.978,462960,192641,270319,4.364,10.487,286535,6.491,20.974,5,17,8135
1979,h) 2500 to 4999,1381,53148,3406639,3276356,8295,16.16,4659,9.077,607347,251354,355993,7.672,18.537,349652,142646,207006,4.354,10.672,257695,7.865,21.344,(D),(D),(D)
1979,i) 5000 to 9999,807,55103,3869219,3759389,5673,10.484,3692,6.823,612180,197241,414939,5.247,16.284,393759,124872,268887,3.322,10.474,218421,5.81,20.948,(D),(D),(D)
1979,j) 10000+,692,229392,18463573,18100847,24260,10.719,18143,8.016,2523520,758153,1765367,4.188,13.941,1783019,578044,1204975,3.193,9.85,740501,4.091,19.701,0,0,0
1980,a) 1 to 4,2203441,2211777,5204244,5177158,454261,20.753,408464,18.661,1760237,1176205,584032,22.719,34.0,1708044,1018818,689226,19.679,32.992,52193,1.008,65.984,328110,329340,831739
1980,b) 5 to 9,715099,734978,5024685,5055293,37994,5.184,33860,4.62,1102549,453518,649031,8.971,21.81,1162594,403066,759528,7.973,22.998,-60045,-1.188,43.62,25010,26076,330929
1980,c) 10 to 19,426026,464609,5960740,5984463,17796,3.834,16973,3.656,1107867,366024,741843,6.116,18.512,1154547,339448,815099,5.672,19.292,-46680,-0.78,37.025,10007,11003,268784
1980,d) 20 to 99,342623,468136,13653266,13664882,19385,4.141,19375,4.139,2223574,591928,1631646,4.332,16.272,2247568,583151,1664417,4.268,16.448,-23994,-0.176,32.544,5088,6439,365049
1980,e) 100 to 499,51418,181073,9879321,9851170,14161,7.851,12777,7.083,1526984,422347,1104637,4.287,15.501,1475108,457593,1017515,4.645,14.974,51876,0.527,29.948,341,829,116439
1980,f) 500 to 999,5777,55718,3561574,3525953,5830,10.584,4561,8.28,522238,189154,333084,5.365,14.811,451688,147529,304159,4.184,12.81,70550,2.001,25.621,18,63,19032
1980,g) 1000 to 2499,3597,68784,4699111,4621187,8831,13.069,6405,9.479,676134,269588,406546,5.834,14.631,517813,192969,324844,4.176,11.205,158321,3.426,22.41,3,3,4126
1980,h) 2500 to 4999,1393,55219,3503557,3456651,7210,13.42,4222,7.859,507389,222363,285026,6.433,14.679,410138,157767,252371,4.564,11.865,97251,2.813,23.73,(D),(D),(D)
1980,i) 5000 to 9999,832,57864,3857790,3860388,6504,11.247,6432,11.123,522280,228078,294202,5.908,13.529,529844,248872,280972,6.447,13.725,-7564,-0.196,27.058,0,0,0
1980,j) 10000+,725,235093,18764979,18821076,20512,8.751,19134,8.163,2293091,760080,1533011,4.038,12.184,2395710,696922,1698788,3.703,12.729,-102619,-0.545,24.367,0,0,0
1981,a) 1 to 4,2228625,2236346,5278265,5233394,446001,20.048,422703,19.0,1784809,1174465,610344,22.442,34.104,1695696,1045378,650318,19.975,32.401,89113,1.703,64.803,336693,338377,852375
1981,b) 5 to 9,718787,739291,5111099,5064828,39255,5.335,32381,4.4,1167999,488562,679437,9.646,23.061,1076163,391640,684523,7.733,21.248,91836,1.813,42.496,24719,26099,327592
1981,c) 10 to 19,426434,465517,6030393,5982673,18971,4.092,15102,3.258,1178495,425777,752718,7.117,19.698,1082230,330400,751830,5.523,18.089,96265,1.609,36.179,10215,11271,274248
1981,d) 20 to 99,343263,472809,13768629,13641908,24337,5.198,15099,3.225,2364655,772530,1592125,5.663,17.334,2108657,523896,1584761,3.84,15.457,255998,1.877,30.914,5288,6777,372082
1981,e) 100 to 499,52168,189870,10012308,9902834,17712,9.544,9125,4.917,1612560,568816,1043744,5.744,16.284,1392138,303601,1088537,3.066,14.058,220422,2.226,28.116,336,883,110140
1981,f) 500 to 999,5983,59112,3641054,3572105,7532,13.261,2908,5.12,579669,237982,341687,6.662,16.228,438999,108595,330404,3.04,12.29,140670,3.938,24.579,20,291,20593
1981,g) 1000 to 2499,3777,72491,4823873,4736267,9060,12.985,3625,5.195,685949,291325,394624,6.151,14.483,511365,138824,372541,2.931,10.797,174584,3.686,21.594,17,39,34462
1981,h) 2500 to 4999,1494,62432,3717885,3666728,8037,13.448,2701,4.519,501148,225512,275636,6.15,13.667,397296,80814,316482,2.204,10.835,103852,2.832,21.67,0,0,0
1981,i) 5000 to 9999,850,63827,3860983,3783073,7774,12.651,3022,4.918,521390,225474,295916,5.96,13.782,367280,87989,279291,2.326,9.709,154110,4.074,19.417,3,11,14215
1981,j) 10000+,817,253784,19484163,19340254,28174,11.389,15381,6.217,2485149,967276,1517873,5.001,12.85,2202538,467706,1734832,2.418,11.388,282611,1.461,22.777,0,0,0
1982,a) 1 to 4,2185739,2194440,5239501,5251949,431489,19.495,469208,21.199,1785909,1133653,652256,21.585,34.005,1808526,1160330,648196,22.093,34.435,-22617,-0.431,68.009,367457,368970,938230
1982,b) 5 to 9,720237,740860,5061229,5088317,39409,5.327,37169,5.025,1119444,445822,673622,8.762,22.0,1172898,433038,739860,8.51,23.051,-53454,-1.051,44.001,27181,28314,361139
1982,c) 10 to 19,424824,463392,5922975,5958003,20317,4.387,19703,4.255,1135876,393199,742677,6.6,19.065,1204883,375790,829093,6.307,20.223,-69007,-1.158,38.129,11306,12412,303798
1982,d) 20 to 99,340299,471810,13545182,13570230,20653,4.388,18295,3.887,2314682,674670,1640012,4.972,17.057,2366317,593511,1772806,4.374,17.438,-51635,-0.381,34.114,6106,7687,435105
1982,e) 100 to 499,52426,197279,10080285,10024421,14323,7.366,8634,4.441,1621579,486137,1135442,4.85,16.176,1511479,323958,1187521,3.232,15.078,110100,1.098,30.156,419,1049,137066
1982,f) 500 to 999,5863,61602,3593547,3574002,4799,7.883,3357,5.514,492217,146868,345349,4.109,13.772,452137,111152,340985,3.11,12.651,40080,1.121,25.301,13,62,17696
1982,g) 1000 to 2499,3838,76561,4952837,4912748,6591,8.703,4931,6.511,625391,206551,418840,4.204,12.73,542944,145523,397421,2.962,11.052,82447,1.678,22.103,6,7,18910
1982,h) 2500 to 4999,1456,60660,3694576,3684475,5204,8.71,3384,5.664,487395,189470,297925,5.142,13.228,462463,122672,339791,3.329,12.552,24932,0.677,25.103,0,0,0
1982,i) 5000 to 9999,883,68604,3974906,3990592,6124,9.036,4458,6.578,474115,171795,302320,4.305,11.881,505910,144071,361839,3.61,12.678,-31795,-0.797,23.762,0,0,0
1982,j) 10000+,882,263561,18857188,19212539,23121,8.821,20229,7.718,2017720,627065,1390655,3.264,10.502,2721835,645194,2076641,3.358,14.167,-704115,-3.665,21.004,0,0,0
1983,a) 1 to 4,2283454,2291931,5437359,5304723,486466,21.74,377854,16.886,1857223,1244462,612761,23.46,35.011,1591591,971227,620364,18.309,30.003,265632,5.007,60.007,297921,299459,794865
1983,b) 5 to 9,732890,754170,5177199,5146361,38718,5.157,32031,4.266,1112854,453619,659235,8.814,21.624,1051761,385165,666596,7.484,20.437,61093,1.187,40.874,24759,26104,328502
1983,c) 10 to 19,425400,466931,5951208,5959345,19519,4.191,17172,3.687,1104298,389445,714853,6.535,18.531,1120871,345656,775215,5.8,18.809,-16573,-0.278,37.061,10778,12112,289631
1983,d) 20 to 99,337862,472397,13382023,13423830,22671,4.809,20712,4.394,2240471,671191,1569280,5.0,16.69,2321176,599361,1721815,4.465,17.291,-80705,-0.601,33.381,5959,8095,425918
1983,e) 100 to 499,52154,196948,9857722,9910081,15023,7.648,13989,7.122,1593959,493508,1100451,4.98,16.084,1696978,396782,1300196,4.004,17.124,-103019,-1.04,32.168,406,1155,134003
1983,f) 500 to 999,6064,62000,3559513,3574337,5215,8.452,4613,7.477,518862,172358,346504,4.822,14.516,549576,121477,428099,3.399,15.376,-30714,-0.859,29.033,6,7,7781
1983,g) 1000 to 2499,3901,75852,4864461,4863021,6536,8.659,5794,7.676,644604,242887,401717,4.995,13.255,639459,161405,478054,3.319,13.149,5145,0.106,26.299,4,5,11868
1983,h) 2500 to 4999,1549,61051,3709248,3693782,5175,8.545,4192,6.922,570846,280053,290793,7.582,15.454,543686,131438,412248,3.558,14.719,27160,0.735,29.438,(D),(D),(D)
1983,i) 5000 to 9999,940,67648,4060401,4052963,4939,7.264,5636,8.289,652567,292694,359873,7.222,16.101,634872,194890,439982,4.809,15.664,17695,0.437,31.329,(D),(D),(D)
1983,j) 10000+,920,264610,18179420,18615114,17592,6.551,25465,9.483,2290544,576163,1714381,3.095,12.305,3174216,980536,2193680,5.267,17.052,-883672,-4.747,24.61,0,0,0
1984,a) 1 to 4,2387492,2395862,5817107,5518708,551796,23.786,399730,17.231,2171709,1448270,723439,26.243,39.352,1571145,1009153,561992,18.286,28.469,600564,10.882,56.939,321909,323675,837476
1984,b) 5 to 9,760145,782262,5539417,5338493,40640,5.223,32381,4.161,1348997,505273,843724,9.465,25.269,947854,387175,560679,7.253,17.755,401143,7.514,35.51,24924,26319,331038
1984,c) 10 to 19,438879,480905,6383435,6155908,18162,3.783,16459,3.429,1382427,411521,970906,6.685,22.457,927010,343445,583565,5.579,15.059,455417,7.398,30.118,10854,12257,292225
1984,d) 20 to 99,349374,483936,14470237,13899308,19944,4.134,16842,3.491,2877055,658750,2218305,4.739,20.699,1735187,554935,1180252,3.993,12.484,1141868,8.215,24.968,5696,7163,403999
1984,e) 100 to 499,54025,202613,10666201,10272210,15843,7.915,10968,5.479,1985409,488960,1496449,4.76,19.328,1196340,338953,857387,3.3,11.646,789069,7.682,23.293,390,749,131536
1984,f) 500 to 999,6097,65106,3850573,3705352,6151,9.628,3711,5.809,663127,215405,447722,5.813,17.896,374197,96094,278103,2.593,10.099,288930,7.798,20.198,9,15,12724
1984,g) 1000 to 2499,3971,80217,5224083,5036941,7632,9.695,4648,5.904,856474,366375,490099,7.274,17.004,488539,125410,363129,2.49,9.699,367935,7.305,19.398,6,25,16748
1984,h) 2500 to 4999,1601,60849,3888746,3790709,5556,9.3,3345,5.599,636438,238786,397652,6.299,16.789,439489,104146,335343,2.747,11.594,196949,5.196,23.188,(D),(D),(D)
1984,i) 5000 to 9999,907,69203,4036887,4000829,5707,8.376,3575,5.247,578930,213101,365829,5.326,14.47,506058,101284,404774,2.532,12.649,72872,1.821,25.298,0,0,0
1984,j) 10000+,892,281021,18975988,18719354,26130,9.413,19285,6.947,2681775,982980,1698795,5.251,14.326,2152600,715590,1437010,3.823,11.499,529175,2.827,22.999,(D),(D),(D)
1985,a) 1 to 4,2403474,2411451,5878296,5691906,545634,23.012,464801,19.603,2166433,1450101,716332,25.477,38.062,1789074,1194073,595001,20.978,31.432,377359,6.63,62.864,373726,375913,988978
1985,b) 5 to 9,787851,809277,5690111,5581602,43667,5.406,40547,5.02,1358129,545486,812643,9.773,24.332,1141426,498578,642848,8.933,20.45,216703,3.882,40.9,31889,33541,424114
1985,c) 10 to 19,456086,496103,6560388,6447430,20243,4.079,20623,4.155,1378354,452438,925916,7.017,21.378,1152335,470958,681377,7.305,17.873,226019,3.506,35.746,14652,16200,396775
1985,d) 20 to 99,365476,496904,15000648,14727226,19242,3.873,18986,3.822,2807801,733002,2074799,4.977,19.065,2260960,843056,1417904,5.724,15.352,546841,3.713,30.704,8928,11078,652676
1985,e) 100 to 499,57184,210064,11271120,10962457,15778,7.598,10990,5.292,2057298,531273,1526025,4.846,18.767,1440551,478750,961801,4.367,13.141,616747,5.626,26.282,720,1698,250139
1985,f) 500 to 999,6413,65535,4016990,3906717,6434,9.968,4452,6.898,720564,230879,489685,5.91,18.444,496779,163988,332791,4.198,12.716,223785,5.728,25.432,39,507,53468
1985,g) 1000 to 2499,4141,84035,5494278,5363975,8612,10.405,6073,7.338,857967,290982,566985,5.425,15.995,592371,201589,390782,3.758,11.044,265596,4.951,22.087,12,91,35011
1985,h) 2500 to 4999,1589,61624,3928029,3868639,6854,11.391,3944,6.555,603087,234520,368567,6.062,15.589,483025,165225,317800,4.271,12.486,120062,3.103,24.971,(D),(D),(D)
1985,i) 5000 to 9999,949,77049,4315621,4258668,7309,9.605,5404,7.102,679699,286251,393448,6.722,15.96,564494,178747,385747,4.197,13.255,115205,2.705,26.51,0,0,0
1985,j) 10000+,952,282390,19927945,19709075,22287,7.822,27367,9.605,2772142,932668,1839474,4.732,14.065,2352636,844922,1507714,4.287,11.937,419506,2.128,23.874,0,0,0
1986,a) 1 to 4,2434643,2443362,5943447,5776850,539584,22.474,454769,18.941,2147888,1437433,710455,24.883,37.181,1810492,1189999,620493,20.599,31.34,337396,5.84,62.681,362457,364395,975947
1986,b) 5 to 9,813233,835439,5841633,5732724,46993,5.653,38628,4.647,1377046,555240,821806,9.685,24.021,1158954,478789,680165,8.352,20.216,218092,3.804,40.433,30726,32108,408379
1986,c) 10 to 19,474708,516261,6781310,6646903,25761,5.024,18748,3.656,1432804,500734,932070,7.533,21.556,1163655,420129,743526,6.321,17.507,269149,4.049,35.013,13301,14895,357916
1986,d) 20 to 99,383323,522380,15644357,15317336,34486,6.689,20926,4.059,3076501,974639,2101862,6.363,20.085,2422242,738348,1683894,4.82,15.814,654259,4.271,31.627,7471,9701,541788
1986,e) 100 to 499,59237,210133,11388003,11238134,17858,8.578,13972,6.711,2101306,631653,1469653,5.621,18.698,1801225,471878,1329347,4.199,16.028,300081,2.67,32.056,595,1201,201552
1986,f) 500 to 999,6749,69284,4114216,4070104,8077,12.012,3995,5.941,693027,254676,438351,6.257,17.027,603371,153898,449473,3.781,14.824,89656,2.203,29.649,26,196,33555
1986,g) 1000 to 2499,4336,87449,5636806,5534732,9929,11.65,5487,6.438,903619,377189,526430,6.815,16.326,694180,169413,524767,3.061,12.542,209439,3.784,25.085,8,8,20237
1986,h) 2500 to 4999,1727,64354,4094638,4039046,6807,10.752,4716,7.449,636556,257296,379260,6.37,15.76,525874,129239,396635,3.2,13.02,110682,2.74,26.04,0,0,0
1986,i) 5000 to 9999,1001,79126,4351346,4323028,7737,9.879,6114,7.807,620701,230971,389730,5.343,14.358,564895,179522,385373,4.153,13.067,55806,1.291,26.134,(D),(D),(D)
1986,j) 10000+,977,294938,20420703,20422619,22802,7.732,22760,7.717,2439497,786785,1652712,3.853,11.945,2443459,768655,1674804,3.764,11.964,-3962,-0.019,23.89,0,0,0
1987,a) 1 to 4,2460669,2468410,6008400,5859802,545987,22.463,470286,19.349,2174731,1451248,723483,24.766,37.113,1875798,1234491,641307,21.067,32.011,298933,5.101,64.023,378619,380487,1021844
1987,b) 5 to 9,829858,850928,5963291,5865629,49079,5.781,45306,5.336,1422634,569987,852647,9.717,24.254,1228240,519738,708502,8.861,20.94,194394,3.314,41.879,32926,34369,436403
1987,c) 10 to 19,485984,527626,6936519,6849078,26828,5.092,25407,4.822,1495478,517466,978012,7.555,21.835,1322194,489072,833122,7.141,19.305,173284,2.53,38.609,14907,16222,400816
1987,d) 20 to 99,391002,538718,16015502,15774391,33373,6.237,26017,4.863,3196623,993332,2203291,6.297,20.265,2715953,869582,1846371,5.513,17.217,480670,3.047,34.435,8830,11143,642693
1987,e) 100 to 499,61966,224693,12169822,11971588,22242,10.058,15113,6.834,2472096,873555,1598541,7.297,20.65,2080007,564486,1515521,4.715,17.375,392089,3.275,34.749,754,1801,260377
1987,f) 500 to 999,7202,71075,4363328,4300438,7190,10.235,5539,7.885,826968,352131,474837,8.188,19.23,699992,198782,501210,4.622,16.277,126976,2.953,32.554,28,245,38088
1987,g) 1000 to 2499,4510,87308,5849377,5861894,10467,12.254,6681,7.822,969469,441639,527830,7.534,16.538,995104,248236,746868,4.235,16.976,-25635,-0.437,33.077,10,283,28745
1987,h) 2500 to 4999,1778,71897,4250376,4247791,7711,10.905,5336,7.546,683707,277232,406475,6.526,16.096,678369,208814,469555,4.916,15.97,5338,0.126,31.94,(D),(D),(D)
1987,i) 5000 to 9999,1094,85730,4514439,4573115,11387,13.647,6812,8.164,653858,254152,399706,5.558,14.298,772064,223319,548745,4.883,16.883,-118206,-2.585,28.596,0,0,0
1987,j) 10000+,971,298785,19997748,20259526,27879,9.264,32205,10.701,2628755,977971,1650784,4.827,12.975,3134829,1133410,2001419,5.594,15.473,-506074,-2.498,25.951,0,0,0
1988,a) 1 to 4,2494847,2502589,6080390,5945443,540774,21.947,463519,18.812,2153624,1428226,725398,24.022,36.223,1882686,1191807,690879,20.046,31.666,270938,4.557,63.332,371730,373706,984658
1988,b) 5 to 9,850428,871425,6098516,6002661,47535,5.482,38780,4.473,1397332,550011,847321,9.163,23.279,1205653,474507,731146,7.905,20.085,191679,3.193,40.171,30762,32391,408053
1988,c) 10 to 19,500721,544606,7154075,7041452,24718,4.557,20236,3.731,1461643,489638,972005,6.954,20.758,1237109,435607,801502,6.186,17.569,224534,3.189,35.138,13986,15745,376535
1988,d) 20 to 99,403113,557403,16494503,16230322,32471,5.875,23119,4.183,3092674,913927,2178747,5.631,19.055,2563291,796303,1766988,4.906,15.793,529383,3.262,31.586,8174,10988,599725
1988,e) 100 to 499,64444,238059,12552661,12317987,24972,10.696,15784,6.761,2421750,797817,1623933,6.477,19.66,1949875,595370,1354505,4.833,15.829,471875,3.831,31.659,800,2252,284901
1988,f) 500 to 999,7579,75340,4602169,4503158,8572,11.604,5638,7.632,845920,291401,554519,6.471,18.785,651748,208416,443332,4.628,14.473,194172,4.312,28.946,38,213,52207
1988,g) 1000 to 2499,4774,92865,6251538,6078679,12128,13.425,7075,7.832,1097392,426892,670500,7.023,18.053,748934,269568,479366,4.435,12.321,348458,5.732,24.641,14,130,40074
1988,h) 2500 to 4999,1812,76513,4339381,4279258,8423,11.123,6855,9.052,706881,279656,427225,6.535,16.519,584723,226422,358301,5.291,13.664,122158,2.855,27.328,4,129,26790
1988,i) 5000 to 9999,1053,78900,4648510,4616567,8592,10.953,7678,9.788,771484,265314,506170,5.747,16.711,706672,259020,447652,5.611,15.307,64812,1.404,30.615,(D),(D),(D)
1988,j) 10000+,908,321134,20644665,20514236,35215,11.083,28418,8.944,2959776,965956,1993820,4.709,14.428,2702840,935708,1767132,4.561,13.175,256936,1.252,26.351,0,0,0
1989,a) 1 to 4,2520174,2528364,6128581,5990466,529653,21.247,458699,18.4,2136083,1406712,729371,23.483,35.658,1858192,1187103,671089,19.817,31.019,277891,4.639,62.038,373277,375455,995480
1989,b) 5 to 9,865271,887725,6212718,6108735,44482,5.024,39781,4.493,1414205,546317,867888,8.943,23.151,1207115,489898,717217,8.02,19.76,207090,3.39,39.521,32356,34387,429966
1989,c) 10 to 19,512208,558339,7332107,7202127,21904,3.929,20221,3.627,1470822,472666,998156,6.563,20.422,1210690,442318,768372,6.141,16.81,260132,3.612,33.62,14365,16813,388027
1989,d) 20 to 99,415877,573223,17029843,16680797,30633,5.379,23071,4.052,3154495,914403,2240092,5.482,18.911,2457355,846265,1611090,5.073,14.732,697140,4.179,29.463,8895,12397,648026
1989,e) 100 to 499,66978,246084,13043943,12747385,23148,9.547,15890,6.554,2360572,710022,1650550,5.57,18.518,1765722,547645,1218077,4.296,13.852,594850,4.666,27.703,704,2475,235700
1989,f) 500 to 999,7866,79366,4751672,4658849,8606,11.087,5112,6.586,773728,253810,519918,5.448,16.608,584111,168413,415698,3.615,12.538,189617,4.07,25.075,28,287,40454
1989,g) 1000 to 2499,5057,98136,6555284,6419877,11345,11.864,6331,6.62,1014817,357495,657322,5.569,15.807,747345,216007,531338,3.365,11.641,267472,4.166,23.282,15,145,41095
1989,h) 2500 to 4999,1901,81714,4629798,4542209,8677,10.858,5081,6.358,710928,290418,420510,6.394,15.652,536125,171603,364522,3.778,11.803,174803,3.848,23.606,3,3,18150
1989,i) 5000 to 9999,1071,84843,4783074,4746357,6613,7.779,6944,8.169,718939,244010,474929,5.141,15.147,641417,203424,437993,4.286,13.514,77522,1.633,27.028,0,0,0
1989,j) 10000+,976,338641,21343100,21248868,41718,12.536,29990,9.012,2916119,997951,1918168,4.696,13.724,2764668,827604,1937064,3.895,13.011,151451,0.713,26.022,0,0,0
1990,a) 1 to 4,2542738,2550881,6185307,6056894,524110,20.803,461251,18.308,2131660,1394335,737325,23.021,35.194,1874390,1192883,681507,19.695,30.946,257270,4.248,61.893,377230,379900,1007844
1990,b) 5 to 9,880449,902949,6287851,6214863,42871,4.755,40287,4.468,1395338,526190,869148,8.467,22.452,1250202,494244,755958,7.953,20.116,145136,2.335,40.233,32861,35058,436198
1990,c) 10 to 19,523490,568713,7451945,7361788,21403,3.768,19985,3.518,1452087,463207,988880,6.292,19.725,1272600,448015,824585,6.086,17.287,179487,2.438,34.573,14833,16927,399115
1990,d) 20 to 99,428560,586157,17364904,17141165,28972,4.976,21139,3.631,2999297,879598,2119699,5.131,17.498,2552700,763915,1788785,4.457,14.892,446597,2.605,29.784,8406,11221,605812
1990,e) 100 to 499,69235,254937,13339133,13185384,21295,8.451,15394,6.109,2153287,670548,1482739,5.086,16.331,1846755,516191,1330564,3.915,14.006,306532,2.325,28.012,746,2059,253439
1990,f) 500 to 999,8030,83611,4834912,4768047,9901,12.155,5585,6.857,721835,234413,487422,4.916,15.139,587174,149168,438006,3.128,12.315,134661,2.824,24.63,19,56,24639
1990,g) 1000 to 2499,5146,104058,6713126,6647591,9951,9.69,7221,7.032,909372,325735,583637,4.9,13.68,779455,207679,571776,3.124,11.725,129917,1.954,23.451,7,401,18939
1990,h) 2500 to 4999,1916,83811,4802647,4736511,8734,10.599,5919,7.183,641527,230764,410763,4.872,13.544,508337,133609,374728,2.821,10.732,133190,2.812,21.465,(D),(D),(D)
1990,i) 5000 to 9999,1089,86787,4926939,4867913,6356,7.359,5523,6.395,685903,209788,476115,4.31,14.09,569188,141738,427450,2.912,11.693,116715,2.398,23.385,0,0,0
1990,j) 10000+,985,350209,22077111,22008123,29217,8.386,25641,7.359,2683563,803030,1880533,3.649,12.194,2536506,741390,1795116,3.369,11.525,147057,0.668,23.051,0,0,0
1991,a) 1 to 4,2529111,2538105,6024049,6079811,481570,18.965,483878,19.056,1918634,1255049,663585,20.643,31.557,2032082,1257082,775000,20.676,33.423,-113448,-1.866,63.115,389737,392412,1048056
1991,b) 5 to 9,883695,908489,6162587,6237869,44780,4.935,42483,4.682,1258680,506518,752162,8.12,20.178,1408078,528223,879855,8.468,22.573,-149398,-2.395,40.356,34710,36477,462508
1991,c) 10 to 19,524645,575962,7244366,7347659,30610,5.352,22568,3.946,1314493,496611,817882,6.759,17.89,1520955,515075,1005880,7.01,20.7,-206462,-2.81,35.78,16712,18871,455805
1991,d) 20 to 99,420065,595283,16523893,16856440,46098,7.849,30128,5.13,2760393,1002956,1757437,5.95,16.376,3425407,1093235,2332172,6.486,20.321,-665014,-3.945,32.752,11600,15511,864582
1991,e) 100 to 499,67141,261606,12683885,12905905,24113,9.334,17577,6.804,1896071,680982,1215089,5.277,14.692,2342715,705184,1637531,5.464,18.152,-446644,-3.461,29.383,1161,3419,399857
1991,f) 500 to 999,7948,81584,4686766,4752629,8218,10.156,6889,8.513,629135,216060,413075,4.546,13.238,762334,229804,532530,4.835,16.04,-133199,-2.803,26.475,54,321,73115
1991,g) 1000 to 2499,5154,107517,6636417,6670757,11251,10.627,7960,7.519,837723,319770,517953,4.794,12.558,907461,276022,631439,4.138,13.604,-69738,-1.045,25.116,22,97,62728
1991,h) 2500 to 4999,1930,82756,4672695,4695615,9122,11.236,5982,7.368,572532,221817,350715,4.724,12.193,620911,185615,435296,3.953,13.223,-48379,-1.03,24.386,3,3,22432
1991,i) 5000 to 9999,1128,90931,4889142,4927422,6355,6.969,6866,7.53,576288,186113,390175,3.777,11.696,650398,188597,461801,3.827,13.2,-74110,-1.504,23.391,0,0,0
1991,j) 10000+,959,362932,22257410,22435968,31017,8.569,29052,8.027,2592944,880910,1712034,3.926,11.557,2953405,777742,2175663,3.466,13.164,-360461,-1.607,23.114,(D),(D),(D)
1992,a) 1 to 4,2548525,2554281,6087646,6065922,476258,18.704,460355,18.079,1935987,1230015,705972,20.277,31.916,1893575,1162196,731379,19.159,31.217,42412,0.699,62.433,363424,366161,951539
1992,b) 5 to 9,878219,898660,6184564,6172564,43107,4.795,43939,4.887,1292331,473058,819273,7.664,20.937,1268240,480693,787547,7.788,20.546,24091,0.39,41.093,30137,32028,399662
1992,c) 10 to 19,516141,566476,7228615,7237294,25995,4.59,25738,4.545,1375945,440807,935138,6.091,19.012,1393877,459822,934055,6.354,19.26,-17932,-0.248,38.024,13535,15162,365871
1992,d) 20 to 99,410845,599175,16468054,16373060,32969,5.535,25956,4.357,2891615,817394,2074221,4.992,17.661,2702824,770943,1931881,4.709,16.508,188791,1.153,33.016,7766,10799,565992
1992,e) 100 to 499,65785,271602,12757128,12635390,19958,7.398,16276,6.033,2119072,594630,1524442,4.706,16.771,1874874,513028,1361846,4.06,14.838,244198,1.933,29.677,711,2360,242405
1992,f) 500 to 999,7830,82935,4680362,4626915,8727,10.714,5764,7.076,721273,247668,473605,5.353,15.589,614079,163466,450613,3.533,13.272,107194,2.317,26.544,27,353,37679
1992,g) 1000 to 2499,5112,110098,6670185,6650834,9679,8.811,9188,8.364,893097,280870,612227,4.223,13.428,851940,270837,581103,4.072,12.81,41157,0.619,25.619,13,59,44986
1992,h) 2500 to 4999,1998,82101,4838139,4811161,7541,9.203,7218,8.809,652331,209189,443142,4.348,13.559,598554,186551,412003,3.877,12.441,53777,1.118,24.882,4,4,27060
1992,i) 5000 to 9999,1100,94137,5041865,5037785,6309,6.696,6487,6.885,656320,235746,420574,4.68,13.028,649091,184482,464609,3.662,12.884,7229,0.143,25.769,(D),(D),(D)
1992,j) 10000+,886,358582,21796377,22141123,24825,6.822,35480,9.75,2524286,797066,1727220,3.6,11.401,3208239,1066909,2141330,4.819,14.49,-683953,-3.089,22.802,(D),(D),(D)
1993,a) 1 to 4,2601155,2606495,6235652,6098014,502541,19.568,425819,16.581,2031340,1292564,738776,21.196,33.312,1754837,1071266,683571,17.567,28.777,276503,4.534,57.554,340148,341783,885323
1993,b) 5 to 9,886535,904810,6277947,6208565,38303,4.241,34842,3.858,1305581,463005,842576,7.458,21.029,1166442,418314,748128,6.738,18.788,139139,2.241,37.575,27228,28816,360559
1993,c) 10 to 19,518996,569533,7325011,7244715,19563,3.437,18995,3.337,1360156,411265,948891,5.677,18.774,1200302,384343,815959,5.305,16.568,159854,2.206,33.136,12078,13848,325551
1993,d) 20 to 99,415401,602988,16721569,16540139,23547,3.901,24679,4.089,2798032,728374,2069658,4.404,16.917,2438889,665155,1773734,4.021,14.745,359143,2.171,29.491,6649,10033,485804
1993,e) 100 to 499,67664,273285,13150242,12947358,17446,6.345,20748,7.546,2190134,557588,1632546,4.307,16.916,1785847,501611,1284236,3.874,13.793,404287,3.123,27.586,591,3051,207272
1993,f) 500 to 999,7855,80198,4701281,4647596,6139,7.648,6290,7.836,712134,198934,513200,4.28,15.323,605691,186668,419023,4.016,13.032,106443,2.29,26.065,26,284,35450
1993,g) 1000 to 2499,5110,109288,6724337,6661530,8487,7.787,7900,7.248,889616,259317,630299,3.893,13.355,760204,233231,526973,3.501,11.412,129412,1.943,22.824,14,24,38796
1993,h) 2500 to 4999,1981,87001,5038596,4993890,6641,7.576,7950,9.07,635137,203442,431695,4.074,12.718,548464,176716,371748,3.539,10.983,86673,1.736,21.965,(D),(D),(D)
1993,i) 5000 to 9999,1122,91451,5073454,5025523,6948,7.637,5993,6.588,647852,214563,433289,4.269,12.891,548451,151584,396867,3.016,10.913,99401,1.978,21.827,0,0,0
1993,j) 10000+,1007,353704,22004657,22155242,25093,6.946,40228,11.135,2706848,766757,1940091,3.461,12.218,3019891,984927,2034964,4.446,13.631,-313043,-1.413,24.435,0,0,0
1994,a) 1 to 4,2653611,2659658,6313122,6208392,511451,19.519,432643,16.511,2046703,1307313,739390,21.057,32.967,1837685,1092865,744820,17.603,29.6,209018,3.367,59.2,349303,351028,912262
1994,b) 5 to 9,898987,918391,6373268,6310846,39889,4.352,36097,3.939,1326253,478694,847559,7.585,21.015,1201158,430708,770450,6.825,19.033,125095,1.982,38.066,28290,30310,375891
1994,c) 10 to 19,527051,575828,7467752,7379468,21481,3.737,19595,3.409,1389073,428609,960464,5.808,18.823,1212784,398473,814311,5.4,16.435,176289,2.389,32.869,12700,14811,342487
1994,d) 20 to 99,424643,612455,17288467,16999011,26625,4.368,20945,3.436,2880362,804631,2075731,4.733,16.944,2302121,678886,1623235,3.994,13.543,578241,3.402,27.085,7369,11289,539498
1994,e) 100 to 499,69417,277362,13544415,13297568,18799,6.838,13883,5.05,2128345,584533,1543812,4.396,16.006,1636238,475882,1160356,3.579,12.305,492107,3.701,24.61,696,2329,235092
1994,f) 500 to 999,8081,82888,4880807,4797006,7985,9.779,5514,6.753,696725,223386,473339,4.657,14.524,528558,149421,379137,3.115,11.018,168167,3.506,22.037,35,289,45721
1994,g) 1000 to 2499,5372,112007,6913644,6809656,11570,10.503,7883,7.156,940890,317948,622942,4.669,13.817,732510,217835,514675,3.199,10.757,208380,3.06,21.514,16,328,42820
1994,h) 2500 to 4999,2097,90516,5150474,5100144,9073,10.224,5526,6.227,610050,198494,411556,3.892,11.961,510156,156944,353212,3.077,10.003,99894,1.959,20.006,3,3,17991
1994,i) 5000 to 9999,1202,94179,5264971,5186895,10430,11.372,5508,6.005,696080,275440,420640,5.31,13.42,536527,134133,402394,2.586,10.344,159553,3.076,20.688,0,0,0
1994,j) 10000+,1142,371582,22515320,22557865,32989,8.876,33183,8.928,2715344,980438,1734906,4.346,12.037,2795173,910983,1884190,4.038,12.391,-79829,-0.354,24.074,0,0,0
1995,a) 1 to 4,2715885,2721974,6451595,6280648,529227,19.794,432550,16.178,2112916,1350257,762659,21.499,33.642,1768834,1081854,686980,17.225,28.163,344082,5.478,56.326,350044,352005,906556
1995,b) 5 to 9,906601,926009,6468898,6352163,39736,4.302,35041,3.794,1355787,486345,869442,7.656,21.344,1122928,421649,701279,6.638,17.678,232859,3.666,35.356,28022,30008,371852
1995,c) 10 to 19,536375,583754,7651784,7493380,20827,3.573,19000,3.26,1434895,435749,999146,5.815,19.149,1117656,391357,726299,5.223,14.915,317239,4.234,29.83,12622,14934,341835
1995,d) 20 to 99,439327,626837,17957941,17539186,26069,4.176,21005,3.365,2993474,794515,2198959,4.53,17.067,2154578,681759,1472819,3.887,12.284,838896,4.783,24.569,7436,12022,555032
1995,e) 100 to 499,72546,281302,14097435,13788984,19448,6.989,13377,4.807,2224951,613981,1610970,4.453,16.136,1611229,456849,1154380,3.313,11.685,613722,4.451,23.37,656,2362,228330
1995,f) 500 to 999,8226,88909,5022464,4910830,8591,9.849,5219,5.984,748850,241764,507086,4.923,15.249,524865,145864,379001,2.97,10.688,223985,4.561,21.376,32,476,44329
1995,g) 1000 to 2499,5417,115382,7032932,6892599,12194,10.772,7829,6.916,971411,344229,627182,4.994,14.094,688609,191424,497185,2.777,9.991,282802,4.103,19.981,9,415,26627
1995,h) 2500 to 4999,2244,95398,5631624,5507896,10464,11.265,5454,5.871,763839,261138,502701,4.741,13.868,515347,131259,384088,2.383,9.357,248492,4.512,18.713,(D),(D),(D)
1995,i) 5000 to 9999,1297,93480,5212794,5133668,10648,11.677,6065,6.651,733842,289098,444744,5.631,14.295,573742,148206,425536,2.887,11.176,160100,3.119,22.352,0,0,0
1995,j) 10000+,1125,391617,23688370,23527284,33007,8.42,33770,8.615,2956250,1071632,1884618,4.555,12.565,2623318,799936,1823382,3.4,11.15,332932,1.415,22.3,0,0,0
1996,a) 1 to 4,2745248,2751228,6482929,6358437,523408,19.281,450207,16.584,2079536,1335097,744439,20.997,32.705,1829528,1125619,703909,17.703,28.773,250008,3.932,57.546,364976,366934,945175
1996,b) 5 to 9,915371,934427,6496923,6423847,39840,4.271,36582,3.922,1323030,488165,834865,7.599,20.596,1176022,445001,731021,6.927,18.307,147008,2.288,36.614,29418,31354,392594
1996,c) 10 to 19,542174,587642,7657140,7572585,21121,3.599,19534,3.329,1373752,442209,931543,5.84,18.141,1204354,412318,792036,5.445,15.904,169398,2.237,31.808,13327,15385,360382
1996,d) 20 to 99,445281,631731,17961403,17793780,26069,4.141,21686,3.445,2789989,815377,1974612,4.582,15.68,2455197,745910,1709287,4.192,13.798,334792,1.882,27.596,8142,12948,605532
1996,e) 100 to 499,72245,285439,13880123,13769008,19694,6.978,13254,4.696,2011113,594031,1417082,4.314,14.606,1789692,478077,1311615,3.472,12.998,221421,1.608,25.996,742,2473,255036
1996,f) 500 to 999,8358,88396,5058135,5002902,7579,8.639,6257,7.132,727657,230239,497418,4.602,14.545,615392,181457,433935,3.627,12.301,112265,2.244,24.601,42,388,56563
1996,g) 1000 to 2499,5372,112445,6953091,6894621,11016,9.938,7831,7.064,912545,316670,595875,4.593,13.236,798146,222773,575373,3.231,11.576,114399,1.659,23.153,9,42,23486
1996,h) 2500 to 4999,2171,97773,5458661,5417833,9796,10.144,7396,7.658,696546,245231,451315,4.526,12.857,615864,177299,438565,3.273,11.367,80682,1.489,22.735,(D),(D),(D)
1996,i) 5000 to 9999,1303,106604,5553769,5489960,10301,9.796,7405,7.042,747094,262007,485087,4.772,13.608,621448,167559,453889,3.052,11.32,125646,2.289,22.639,0,0,0
1996,j) 10000+,1122,403767,24439626,24465443,34840,8.636,34130,8.46,3091273,1072048,2019225,4.382,12.635,3147713,976338,2171375,3.991,12.866,-56440,-0.231,25.271,0,0,0
1997,a) 1 to 4,2773195,2777481,6551014,6439686,525737,19.129,467461,17.009,2099418,1334365,765053,20.721,32.601,1874697,1180163,694534,18.326,29.112,224721,3.49,58.223,378485,381106,988170
1997,b) 5 to 9,924650,940997,6579303,6507155,42095,4.471,43182,4.586,1361738,496300,865438,7.627,20.927,1218634,492938,725696,7.575,18.728,143104,2.199,37.455,31472,33564,419812
1997,c) 10 to 19,549884,592959,7802416,7707809,24217,4.078,25969,4.373,1462411,453063,1009348,5.878,18.973,1274243,476015,798228,6.176,16.532,188168,2.441,33.064,14571,16859,393622
1997,d) 20 to 99,453884,641850,18543149,18214500,32913,5.141,29730,4.643,3255496,872198,2383298,4.788,17.873,2596486,883425,1713061,4.85,14.255,659010,3.618,28.51,8878,13538,658930
1997,e) 100 to 499,73757,293401,14440143,14144575,24368,8.423,16154,5.584,2495154,705680,1789474,4.989,17.64,1901855,587328,1314527,4.152,13.446,593299,4.195,26.892,902,3173,321567
1997,f) 500 to 999,8426,92700,5225098,5142794,9958,10.942,6570,7.219,840762,284476,556286,5.532,16.348,675491,213429,462062,4.15,13.135,165271,3.214,26.269,59,847,87397
1997,g) 1000 to 2499,5391,118597,7196956,7048262,13852,11.89,9655,8.288,1204837,456180,748657,6.472,17.094,906760,267885,638875,3.801,12.865,298077,4.229,25.73,14,421,36983
1997,h) 2500 to 4999,2150,93659,5511079,5491261,11075,11.933,9375,10.101,823218,298792,524426,5.441,14.991,783652,240098,543554,4.372,14.271,39566,0.721,28.542,3,3,21865
1997,i) 5000 to 9999,1204,104123,5625867,5569188,12192,11.823,10182,9.874,862533,341731,520802,6.136,15.488,748640,215614,533026,3.872,13.443,113893,2.045,26.885,0,0,0
1997,j) 10000+,983,421221,25655058,25449047,44012,10.426,45810,10.852,3932839,1405558,2527281,5.523,15.454,3503625,1236225,2267400,4.858,13.767,429214,1.687,27.534,0,0,0
1998,a) 1 to 4,2803939,2807164,6599788,6505356,508237,18.299,448644,16.154,2043060,1283948,759112,19.737,31.406,1849894,1119553,730341,17.21,28.436,193166,2.969,56.873,352585,353962,901824
1998,b) 5 to 9,938070,951885,6682270,6618642,36121,3.795,36016,3.784,1331597,460760,870837,6.962,20.119,1203733,438107,765626,6.619,18.187,127864,1.932,36.374,27309,29006,364553
1998,c) 10 to 19,559657,599963,7969436,7879698,17789,2.959,20083,3.341,1425874,417681,1008193,5.301,18.096,1244909,417769,827140,5.302,15.799,180965,2.297,31.598,12746,14749,345505
1998,d) 20 to 99,467665,648705,19195022,18898979,22574,3.473,25117,3.864,3136470,812513,2323957,4.299,16.596,2544539,744470,1800069,3.939,13.464,591931,3.132,26.928,7489,11712,552972
1998,e) 100 to 499,77222,298893,15165811,14863637,22613,7.621,18267,6.156,2512607,688328,1824279,4.631,16.904,1912432,537914,1374518,3.619,12.867,600175,4.038,25.733,741,4041,266685
1998,f) 500 to 999,8869,95669,5437255,5326693,10267,10.917,7028,7.473,901061,278792,622269,5.234,16.916,678146,208125,470021,3.907,12.731,222915,4.185,25.462,43,344,57467
1998,g) 1000 to 2499,5611,123632,7403623,7246709,14896,12.398,7932,6.602,1129629,392718,736911,5.419,15.588,812079,242057,570022,3.34,11.206,317550,4.382,22.412,8,155,22480
1998,h) 2500 to 4999,2291,94222,5808847,5678166,10781,11.669,7123,7.709,870577,306458,564119,5.397,15.332,606118,198458,407660,3.495,10.675,264459,4.657,21.349,0,0,0
1998,i) 5000 to 9999,1344,115652,6095559,5931106,15558,13.831,9223,8.199,1016779,364306,652473,6.142,17.143,689283,218490,470793,3.684,11.621,327496,5.522,23.243,0,0,0
1998,j) 10000+,1191,447540,27197559,27021753,47684,10.715,42634,9.58,3784341,1331020,2453321,4.926,14.005,3409950,1188065,2221885,4.397,12.619,374391,1.386,25.239,0,0,0
1999,a) 1 to 4,2811976,2815810,6568289,6504627,495640,17.729,455442,16.291,1997761,1238018,759743,19.033,30.713,1868259,1137449,730810,17.487,28.722,129502,1.991,57.444,356711,358120,910859
1999,b) 5 to 9,942454,956453,6675385,6632152,33333,3.478,37059,3.867,1294694,424287,870407,6.397,19.521,1208920,460615,748305,6.945,18.228,85774,1.293,36.456,28800,30662,383638
1999,c) 10 to 19,566159,604166,8022797,7954761,16304,2.69,20294,3.348,1376239,373353,1002886,4.693,17.301,1239781,444622,795159,5.589,15.585,136458,1.715,31.171,13710,16208,370467
1999,d) 20 to 99,476462,651087,19384855,19167289,22620,3.472,23277,3.573,2920189,711617,2208572,3.713,15.235,2483711,829818,1653893,4.329,12.958,436478,2.277,25.916,8960,15091,672883
1999,e) 100 to 499,79220,304052,15428308,15189302,25245,8.428,16241,5.422,2376169,703526,1672643,4.632,15.644,1898913,565289,1333624,3.722,12.502,477256,3.142,25.003,841,3678,293828
1999,f) 500 to 999,8972,96799,5523282,5450371,10713,11.271,7206,7.582,872182,297667,574515,5.461,16.002,725535,215351,510184,3.951,13.312,146647,2.691,26.623,47,762,60543
1999,g) 1000 to 2499,5647,122220,7569025,7455521,13436,11.186,9231,7.685,1122941,403498,719443,5.412,15.062,888795,278368,610427,3.734,11.921,234146,3.141,23.843,22,384,60895
1999,h) 2500 to 4999,2318,105176,5906594,5799678,14180,13.987,6587,6.497,919076,382799,536277,6.6,15.847,705352,204427,500925,3.525,12.162,213724,3.685,24.324,(D),(D),(D)
1999,i) 5000 to 9999,1339,118435,6264215,6160075,16060,13.905,10183,8.817,1033989,438240,595749,7.114,16.785,822366,240721,581645,3.908,13.35,211623,3.435,26.7,0,0,0
1999,j) 10000+,1172,474287,28489828,28470971,47013,9.937,44632,9.434,3940852,1293558,2647294,4.543,13.842,3907389,1325550,2581839,4.656,13.724,33463,0.118,27.448,0,0,0
2000,a) 1 to 4,2803563,2807911,6584119,6503229,482955,17.269,460300,16.459,2004283,1233991,770292,18.975,30.82,1839348,1142610,696738,17.57,28.284,164935,2.536,56.567,355569,357277,901652
2000,b) 5 to 9,947122,961316,6752967,6665744,35412,3.681,36624,3.807,1350962,451247,899715,6.77,20.267,1176778,452862,723916,6.794,17.654,174184,2.613,35.308,27896,29772,372108
2000,c) 10 to 19,575847,612512,8213984,8133462,17619,2.872,19597,3.194,1456008,403456,1052552,4.96,17.901,1294078,427970,866108,5.262,15.911,161930,1.991,31.821,13060,15532,354262
2000,d) 20 to 99,487735,655554,19996118,19617422,22345,3.412,20959,3.201,3112564,749644,2362920,3.821,15.866,2354045,759018,1595027,3.869,12.0,758519,3.867,24.0,8184,13551,603407
2000,e) 100 to 499,81675,307582,16015766,15625248,23202,7.626,16498,5.423,2561003,682650,1878353,4.369,16.39,1778182,514177,1264005,3.291,11.38,782821,5.01,22.76,727,3882,265076
2000,f) 500 to 999,9263,99082,5745114,5618176,10599,10.886,7155,7.349,926608,291907,634701,5.196,16.493,669257,217025,452232,3.863,11.912,257351,4.581,23.825,45,726,57613
2000,g) 1000 to 2499,5848,128469,7733438,7582524,14987,11.924,9414,7.49,1185153,420637,764516,5.547,15.63,883365,281584,601781,3.714,11.65,301788,3.98,23.3,13,710,44641
2000,h) 2500 to 4999,2406,101639,6083668,5970891,12039,12.101,7744,7.784,950929,371020,579909,6.214,15.926,724836,232385,492451,3.892,12.139,226093,3.787,24.279,(D),(D),(D)
2000,i) 5000 to 9999,1442,122255,6289243,6220792,14824,12.269,11973,9.909,997427,343687,653740,5.525,16.034,860075,294605,565470,4.736,13.826,137352,2.208,27.652,(D),(D),(D)
2000,j) 10000+,1217,499205,29924676,29798690,51604,10.338,51482,10.314,4374982,1478974,2896008,4.963,14.682,4133706,1606122,2527584,5.39,13.872,241276,0.81,27.744,0,0,0
2001,a) 1 to 4,2806730,2812462,6527793,6510004,487265,17.395,464774,16.592,1938092,1233644,704448,18.95,29.771,1901017,1159405,741612,17.81,29.201,37075,0.57,58.403,357400,359259,911345
2001,b) 5 to 9,945674,960753,6660831,6666339,35338,3.674,37516,3.9,1245865,440120,805745,6.602,18.689,1256948,467007,789941,7.005,18.855,-11083,-0.166,37.378,28592,30567,381482
2001,c) 10 to 19,578286,614278,8145689,8129284,18313,2.978,19513,3.173,1335925,401353,934572,4.937,16.433,1303720,436278,867442,5.367,16.037,32205,0.396,32.075,13357,15573,361219
2001,d) 20 to 99,494138,658839,20005813,19901395,25316,3.854,21388,3.256,2874122,759731,2114391,3.817,14.442,2666051,799882,1866169,4.019,13.396,208071,1.046,26.793,8614,13410,644477
2001,e) 100 to 499,82752,311991,15960703,15887628,22840,7.378,18027,5.823,2248654,609339,1639315,3.835,14.153,2102772,597696,1505076,3.762,13.235,145882,0.918,26.471,853,3454,309608
2001,f) 500 to 999,9435,101226,5839616,5801893,9183,9.142,7624,7.59,852124,259044,593080,4.465,14.687,778357,233155,545202,4.019,13.416,73767,1.271,26.831,53,1333,73818
2001,g) 1000 to 2499,5824,130013,7751804,7725347,15460,12.02,12676,9.855,1107393,372759,734634,4.825,14.335,1052235,344698,707537,4.462,13.621,55158,0.714,27.241,30,2390,88067
2001,h) 2500 to 4999,2368,103016,6061915,6029648,13400,13.143,11277,11.061,917405,313626,603779,5.201,15.215,854107,308854,545253,5.122,14.165,63298,1.05,28.33,7,356,48239
2001,i) 5000 to 9999,1337,118641,6408967,6440756,14684,12.518,12010,10.238,964218,393417,570801,6.108,14.971,1019040,346638,672402,5.382,15.822,-54822,-0.851,29.941,(D),(D),(D)
2001,j) 10000+,1126,525457,30464144,30481773,58056,11.105,52700,10.081,4428972,1715108,2713864,5.627,14.53,4481507,1485000,2996507,4.872,14.702,-52535,-0.172,29.06,0,0,0
2002,a) 1 to 4,2828123,2832058,6647674,6615181,508085,17.975,497348,17.595,2058756,1301597,757159,19.676,31.122,1993184,1230336,762848,18.599,30.13,65572,0.991,60.261,372399,374524,960399
2002,b) 5 to 9,951615,965242,6710486,6721350,46185,4.789,44548,4.619,1358405,534105,824300,7.946,20.21,1379694,524753,854941,7.807,20.527,-21289,-0.317,40.421,32703,34326,438523
2002,c) 10 to 19,582486,618993,8176264,8191758,32091,5.205,27155,4.405,1510606,571229,939377,6.973,18.441,1540016,541953,998063,6.616,18.8,-29410,-0.359,36.881,16543,18237,449175
2002,d) 20 to 99,489993,664302,19649924,19832909,45671,6.947,31837,4.843,3321505,1301383,2020122,6.562,16.747,3684670,1153879,2530791,5.818,18.579,-363165,-1.831,33.495,11639,15649,897063
2002,e) 100 to 499,81172,318672,15444453,15669802,24044,7.613,18347,5.809,2353638,849719,1503919,5.423,15.02,2805339,746624,2058715,4.765,17.903,-451701,-2.883,30.04,1259,3942,441237
2002,f) 500 to 999,9450,103749,5641574,5748230,10032,9.765,7992,7.78,805866,276463,529403,4.81,14.019,1018901,293271,725630,5.102,17.725,-213035,-3.706,28.039,81,1258,109016
2002,g) 1000 to 2499,5938,127241,7501119,7633901,11072,8.696,11233,8.823,1061436,371262,690174,4.863,13.904,1324379,410047,914332,5.371,17.349,-262943,-3.444,27.808,36,1157,105495
2002,h) 2500 to 4999,2429,102364,5866984,5951674,10525,10.301,10149,9.933,836357,287219,549138,4.826,14.052,1007189,307960,699229,5.174,16.923,-170832,-2.87,28.105,6,695,43239
2002,i) 5000 to 9999,1398,119198,6165670,6296986,12204,10.277,11308,9.523,892984,330592,562392,5.25,14.181,1146264,331083,815181,5.258,18.203,-253280,-4.022,28.362,(D),(D),(D)
2002,j) 10000+,1247,540038,29825432,30417675,58340,10.801,58572,10.844,4281881,1596562,2685319,5.249,14.077,5494219,1719546,3774673,5.653,18.063,-1212338,-3.986,28.154,(D),(D),(D)
2003,a) 1 to 4,2870411,2874070,6724852,6625330,531939,18.712,469474,16.514,2078195,1324928,753267,19.998,31.367,1874434,1135920,738514,17.145,28.292,203761,3.075,56.584,359335,360776,903420
2003,b) 5 to 9,954969,967156,6747739,6688801,37799,3.915,34684,3.592,1330757,470418,860339,7.033,19.895,1212979,425906,787073,6.367,18.134,117778,1.761,36.269,27283,28687,362419
2003,c) 10 to 19,584985,620949,8248586,8172266,20569,3.315,19520,3.146,1445716,437696,1008020,5.356,17.691,1292548,402318,890230,4.923,15.816,153168,1.874,31.633,12407,14090,334760
2003,d) 20 to 99,491946,666106,19891500,19632588,25742,3.868,24631,3.701,3185548,806264,2379284,4.107,16.226,2667248,728364,1938884,3.71,13.586,518300,2.64,27.172,7286,10947,540158
2003,e) 100 to 499,82960,326846,16056398,15812182,20557,6.306,18850,5.782,2555257,611576,1943681,3.868,16.16,2065684,576948,1488736,3.649,13.064,489573,3.096,26.128,751,2588,262017
2003,f) 500 to 999,9358,104489,5604883,5584265,7390,7.073,7367,7.051,790614,211829,578785,3.793,14.158,748131,204331,543800,3.659,13.397,42483,0.761,26.794,39,353,54060
2003,g) 1000 to 2499,5870,129251,7516999,7496971,11784,9.19,9727,7.586,1025167,325799,699368,4.346,13.674,976912,284883,692029,3.8,13.031,48255,0.644,26.062,23,1038,69442
2003,h) 2500 to 4999,2404,104032,5855498,5880303,9084,8.732,9072,8.721,757265,225924,531341,3.842,12.878,803853,236570,567283,4.023,13.67,-46588,-0.792,25.756,(D),(D),(D)
2003,i) 5000 to 9999,1390,117360,6285561,6330824,11917,10.22,10408,8.926,820699,229067,591632,3.618,12.964,911186,284873,626313,4.5,14.393,-90487,-1.429,25.927,0,0,0
2003,j) 10000+,1516,547123,29387834,29752935,50711,9.231,55232,10.053,3616289,1298335,2317954,4.364,12.154,4369338,1446350,2922988,4.861,14.685,-753049,-2.531,24.309,(D),(D),(D)
2004,a) 1 to 4,2927749,2932129,6861733,6718687,555004,19.223,465242,16.114,2131218,1366552,764666,20.34,31.721,1847367,1128920,718447,16.803,27.496,283851,4.225,54.992,357613,358742,901041
2004,b) 5 to 9,970479,983861,6888170,6800185,37373,3.806,33673,3.429,1363541,477926,885615,7.028,20.052,1188033,427149,760884,6.281,17.471,175508,2.581,34.941,27312,28555,364183
2004,c) 10 to 19,593508,629460,8408403,8308965,18245,2.901,17366,2.761,1453745,426744,1027001,5.136,17.496,1254192,398390,855802,4.795,15.094,199553,2.402,30.189,12564,14317,339065
2004,d) 20 to 99,499787,672556,20229121,19996973,19910,2.966,17445,2.599,2945438,778130,2167308,3.891,14.729,2480286,685299,1794987,3.427,12.403,465152,2.326,24.807,7444,11098,554006
2004,e) 100 to 499,84514,329990,16387416,16242037,18007,5.483,14873,4.529,2156787,555382,1601405,3.419,13.279,1867951,501315,1366636,3.087,11.501,288836,1.778,23.001,753,3264,273148
2004,f) 500 to 999,9262,104230,5664406,5613791,6947,6.646,7546,7.219,737389,195421,541968,3.481,13.135,639490,190164,449326,3.387,11.391,97899,1.744,22.783,35,1091,45277
2004,g) 1000 to 2499,5793,131212,7631111,7577035,12254,9.525,7145,5.554,964905,300783,664122,3.97,12.735,857736,250867,606869,3.311,11.32,107169,1.414,22.64,17,21,51163
2004,h) 2500 to 4999,2325,107864,6044738,6046619,10708,10.044,8205,7.696,751050,233149,517901,3.856,12.421,756760,241709,515051,3.997,12.515,-5710,-0.094,24.842,6,722,38330
2004,i) 5000 to 9999,1342,118180,6376311,6360690,12039,10.343,8468,7.275,867321,259474,607847,4.079,13.636,838321,301702,536619,4.743,13.18,29000,0.456,26.359,0,0,0
2004,j) 10000+,1174,556145,29503094,29580395,53114,9.523,56324,10.098,3794464,1166771,2627693,3.944,12.828,3973033,1375013,2598020,4.648,13.431,-178569,-0.604,25.655,0,0,0
2005,a) 1 to 4,2989187,2994211,6887854,6829503,564366,19.098,486281,16.455,2106804,1374654,732150,20.128,30.849,1992105,1173564,818541,17.184,29.169,114699,1.679,58.338,371457,373091,929227
2005,b) 5 to 9,982980,997128,6897630,6892354,39267,3.947,34944,3.512,1332032,501085,830947,7.27,19.326,1320106,438789,881317,6.366,19.153,11926,0.173,38.306,27849,29415,371052
2005,c) 10 to 19,597895,633604,8347103,8360572,19574,3.094,17627,2.786,1387904,454147,933757,5.432,16.601,1413838,403606,1010232,4.827,16.911,-25934,-0.31,33.201,12696,14485,342321
2005,d) 20 to 99,503315,675713,20220645,20138245,22468,3.337,17690,2.627,2874988,813143,2061845,4.038,14.276,2707458,684002,2023456,3.397,13.444,167530,0.832,26.889,7445,11314,549891
2005,e) 100 to 499,85720,334673,16701134,16451920,22207,6.734,12382,3.755,2305653,636533,1669120,3.869,14.014,1809675,441176,1368499,2.682,11.0,495978,3.015,22.0,650,1807,227736
2005,f) 500 to 999,9505,110189,5891158,5779878,10235,9.441,6671,6.154,862931,282722,580209,4.891,14.93,640237,165316,474921,2.86,11.077,222694,3.853,22.154,38,1089,51742
2005,g) 1000 to 2499,5854,125738,7760729,7681273,10781,8.66,8302,6.668,1003769,328051,675718,4.271,13.068,844504,237822,606682,3.096,10.994,159265,2.073,21.989,14,219,42074
2005,h) 2500 to 4999,2325,108890,6152172,6080813,10082,9.385,7159,6.664,787780,249719,538061,4.107,12.955,641885,200511,441374,3.297,10.556,145895,2.399,21.112,3,3,25247
2005,i) 5000 to 9999,1326,122045,6306189,6285809,9845,8.137,7740,6.397,761506,247572,513934,3.939,12.115,722598,214804,507794,3.417,11.496,38908,0.619,22.991,(D),(D),(D)
2005,j) 10000+,1196,574963,30138847,30188524,54088,9.419,52603,9.161,3499133,1168415,2330718,3.87,11.591,3593111,1091219,2501892,3.615,11.902,-93978,-0.311,23.182,0,0,0
2006,a) 1 to 4,3051464,3056889,7039308,6910614,596644,19.78,515545,17.092,2186565,1432951,753614,20.736,31.641,1927087,1202616,724471,17.402,27.886,259478,3.755,55.772,403286,404979,975077
2006,b) 5 to 9,998118,1013195,7104640,6976327,42660,4.229,33780,3.349,1447364,532635,914729,7.635,20.747,1191924,425611,766313,6.101,17.085,255440,3.662,34.171,27731,29017,368355
2006,c) 10 to 19,605202,643208,8592585,8430166,24771,3.874,17038,2.665,1536946,504076,1032870,5.979,18.232,1210526,389523,821003,4.621,14.359,326420,3.872,28.719,12330,13913,331837
2006,d) 20 to 99,509755,692767,20861971,20432182,36507,5.345,17113,2.505,3301639,1019366,2282273,4.989,16.159,2440423,681185,1759238,3.334,11.944,861216,4.215,23.888,7300,10414,542757
2006,e) 100 to 499,87689,346525,17140617,16834126,27977,8.25,13144,3.876,2490543,768043,1722500,4.562,14.795,1876438,442984,1433454,2.631,11.147,614105,3.648,22.293,621,2363,221245
2006,f) 500 to 999,9831,110125,6072208,5970390,9555,8.819,5989,5.528,834598,223048,611550,3.736,13.979,631982,149265,482717,2.5,10.585,202616,3.394,21.171,32,879,46945
2006,g) 1000 to 2499,6000,136072,8039320,7878342,13944,10.497,7481,5.632,1081477,330531,750946,4.195,13.727,759737,191219,568518,2.427,9.643,321740,4.084,19.287,8,170,26957
2006,h) 2500 to 4999,2396,109252,6341580,6266858,10178,9.48,6400,5.961,786807,262270,524537,4.185,12.555,634298,155736,478562,2.485,10.121,152509,2.434,20.243,(D),(D),(D)
2006,i) 5000 to 9999,1356,123698,6658235,6544022,13836,11.472,7663,6.353,932230,286429,645801,4.377,14.246,708626,219036,489590,3.347,10.829,223604,3.417,21.657,(D),(D),(D)
2006,j) 10000+,1172,607134,31255832,31040977,59785,9.933,49240,8.181,3981413,1349284,2632129,4.347,12.826,3574992,1055727,2519265,3.401,11.517,406421,1.309,23.034,0,0,0
2007,a) 1 to 4,3073773,3078259,6966016,6948749,565870,18.522,519444,17.003,2059098,1340083,719015,19.285,29.633,2029331,1217017,812314,17.514,29.204,29767,0.428,58.409,407033,408768,985759
2007,b) 5 to 9,1005048,1018355,7045230,7039324,41495,4.078,40098,3.94,1366037,505326,860711,7.179,19.406,1354116,473146,880970,6.721,19.236,11921,0.169,38.473,29731,31028,393360
2007,c) 10 to 19,609300,644315,8520317,8502028,23786,3.695,22505,3.496,1435793,483698,952095,5.689,16.888,1399680,447747,951933,5.266,16.463,36113,0.425,32.926,13284,14821,356339
2007,d) 20 to 99,513140,698415,20647139,20602243,31199,4.49,24216,3.485,3085176,899209,2185967,4.365,14.975,2991614,846976,2144638,4.111,14.521,93562,0.454,29.042,7923,10735,587688
2007,e) 100 to 499,87822,351669,16899573,16880708,22811,6.553,15663,4.5,2246468,564946,1681522,3.347,13.308,2207060,521436,1685624,3.089,13.074,39408,0.233,26.149,711,2633,249895
2007,f) 500 to 999,10078,114013,6140653,6082371,9918,8.857,5840,5.215,831985,225260,606725,3.703,13.679,715638,169922,545716,2.794,11.766,116347,1.913,23.532,33,307,45468
2007,g) 1000 to 2499,6373,141718,8287561,8187188,13244,9.494,8795,6.305,1096600,315201,781399,3.85,13.394,896068,243978,652090,2.98,10.945,200532,2.449,21.89,19,154,51898
2007,h) 2500 to 4999,2549,113234,6520131,6435534,11742,10.572,7417,6.678,871030,249289,621741,3.874,13.535,702964,179286,523678,2.786,10.923,168066,2.612,21.846,(D),(D),(D)
2007,i) 5000 to 9999,1452,121802,6723429,6691052,13934,11.562,11353,9.421,886007,303020,582987,4.529,13.242,820704,232646,588058,3.477,12.266,65303,0.976,24.531,(D),(D),(D)
2007,j) 10000+,1382,636588,31934387,32064182,67502,10.634,63838,10.057,4327143,1377978,2949165,4.298,13.495,4588173,1434005,3154168,4.472,14.309,-261030,-0.814,26.991,(D),(D),(D)
2008,a) 1 to 4,3033285,3037411,6805484,6912103,503567,16.435,556788,18.172,1896009,1197090,698919,17.319,27.43,2108636,1270941,837695,18.387,30.506,-212627,-3.076,54.861,434904,436228,1027997
2008,b) 5 to 9,994118,1007450,6916529,6968506,37120,3.684,37632,3.734,1255710,455992,799718,6.544,18.02,1359388,464842,894546,6.671,19.508,-103678,-1.488,36.04,30137,31475,400002
2008,c) 10 to 19,601500,637314,8367622,8401610,21472,3.373,20188,3.171,1302651,433459,869192,5.159,15.505,1371019,429206,941813,5.109,16.319,-68368,-0.814,31.01,13530,15376,364373
2008,d) 20 to 99,508130,692957,20483841,20439418,26810,3.88,23010,3.33,2865488,788181,2077307,3.856,14.019,2777271,759061,2018210,3.714,13.588,88217,0.432,27.176,7886,10972,582495
2008,e) 100 to 499,87792,353375,17051180,16890616,21611,6.159,16629,4.739,2284569,547843,1736726,3.243,13.526,1964963,499217,1465746,2.956,11.633,319606,1.892,23.267,743,2405,253494
2008,f) 500 to 999,10149,116077,6170979,6129874,8246,7.149,6785,5.882,809275,214506,594769,3.499,13.202,728182,190159,538023,3.102,11.879,81093,1.323,23.758,36,421,47308
2008,g) 1000 to 2499,6269,141487,8290832,8268578,10793,7.645,10168,7.202,1020531,268907,751624,3.252,12.342,977592,260437,717155,3.15,11.823,42939,0.519,23.646,21,597,65022
2008,h) 2500 to 4999,2511,118059,6552999,6518954,10828,9.282,8032,6.885,797390,247974,549416,3.804,12.232,730941,213644,517297,3.277,11.213,66449,1.019,22.425,5,383,31493
2008,i) 5000 to 9999,1436,122680,6886379,6836508,15055,12.531,9987,8.312,897055,316122,580933,4.624,13.122,799413,230873,568540,3.377,11.693,97642,1.428,23.387,(D),(D),(D)
2008,j) 10000+,2043,648485,31911782,32154312,49424,7.587,55327,8.493,3745767,1061046,2684721,3.3,11.649,4257703,1208082,3049621,3.757,13.241,-511936,-1.592,23.299,0,0,0
2009,a) 1 to 4,2953748,2958750,6547705,6829600,448624,14.783,600599,19.791,1684103,1050740,633363,15.385,24.659,2249883,1368557,881326,20.039,32.943,-565780,-8.284,49.318,451859,453323,1072051
2009,b) 5 to 9,967959,982613,6614555,6800070,31985,3.248,36423,3.698,1090581,398051,692530,5.854,16.038,1458198,459230,998968,6.753,21.444,-367617,-5.406,32.076,29829,31165,394784
2009,c) 10 to 19,585658,623273,7982469,8201858,17012,2.727,17976,2.882,1090571,361944,728627,4.413,13.297,1528363,410135,1118228,5.001,18.634,-437792,-5.338,26.593,13158,14988,355027
2009,d) 20 to 99,490187,676163,19118147,19751777,20228,2.996,18114,2.683,2105932,635589,1470343,3.218,10.662,3371272,761498,2609774,3.855,17.068,-1265340,-6.406,21.324,8199,11885,630772
2009,e) 100 to 499,84741,353588,15927318,16389841,19611,5.588,14362,4.092,1616167,488564,1127603,2.981,9.861,2538003,534390,2003613,3.26,15.485,-921836,-5.624,19.722,871,2833,311326
2009,f) 500 to 999,9716,118570,5863639,6012340,8208,6.953,7174,6.077,636693,214990,421703,3.576,10.59,932143,189142,743001,3.146,15.504,-295450,-4.914,21.18,47,599,63722
2009,g) 1000 to 2499,6099,145779,7968407,8136885,12282,8.428,12183,8.36,835979,296187,539792,3.64,10.274,1171773,282283,889490,3.469,14.401,-335794,-4.127,20.548,27,1332,69734
2009,h) 2500 to 4999,2418,117350,6257818,6386583,10384,8.93,8260,7.103,627337,219360,407977,3.435,9.823,882480,192990,689490,3.022,13.818,-255143,-3.995,19.645,3,60,19912
2009,i) 5000 to 9999,1357,120359,6527492,6661808,11554,9.668,9863,8.253,695268,260335,434933,3.908,10.437,968647,226531,742116,3.4,14.54,-273379,-4.104,20.873,(D),(D),(D)
2009,j) 10000+,1198,641853,30752345,31484051,48642,7.487,64358,9.906,2949626,979868,1969758,3.112,9.369,4435357,1118407,3316950,3.552,14.088,-1485731,-4.719,18.737,(D),(D),(D)
2010,a) 1 to 4,2938398,2944206,6527113,6664074,456265,15.301,531905,17.837,1677955,1055801,622154,15.843,25.179,1951326,1197951,753375,17.976,29.281,-273371,-4.102,50.358,390168,392008,920446
2010,b) 5 to 9,946462,961894,6567097,6607556,37520,3.911,32572,3.395,1172627,457136,715491,6.918,17.747,1251734,402531,849203,6.092,18.944,-79107,-1.197,35.494,25975,27528,343486
2010,c) 10 to 19,575172,614492,7906430,8010708,15449,2.513,16009,2.604,1086084,326234,759850,4.072,13.558,1293129,355922,937207,4.443,16.143,-207045,-2.585,27.116,11358,13040,305266
2010,d) 20 to 99,468934,660045,18467067,18690154,23656,3.605,15965,2.433,2122498,720738,1401760,3.856,11.356,2568330,562025,2006305,3.007,13.742,-445832,-2.385,22.712,6241,9819,451383
2010,e) 100 to 499,81390,355128,15599505,15636933,22417,6.39,13768,3.925,1787812,573583,1214229,3.668,11.433,1865155,368910,1496245,2.359,11.928,-77343,-0.495,22.867,504,2576,182128
2010,f) 500 to 999,9458,121289,5775202,5800984,7875,6.529,6527,5.411,649288,193797,455491,3.341,11.193,703753,150621,553132,2.596,12.132,-54465,-0.939,22.385,35,319,47572
2010,g) 1000 to 2499,5941,145219,7857440,7934452,10262,7.089,9352,6.46,806789,239960,566829,3.024,10.168,965664,226826,738838,2.859,12.171,-158875,-2.002,20.336,12,636,37880
2010,h) 2500 to 4999,2306,118516,6089871,6170116,8336,7.022,8736,7.359,567992,161919,406073,2.624,9.206,729573,198493,531080,3.217,11.824,-161581,-2.619,18.411,4,339,27075
2010,i) 5000 to 9999,1362,119569,6351514,6398002,11390,9.657,8140,6.902,684413,241843,442570,3.78,10.697,771455,187970,583485,2.938,12.058,-87042,-1.36,21.395,0,0,0
2010,j) 10000+,1181,630829,30050616,30480627,38961,6.092,56367,8.814,2789466,716684,2072782,2.351,9.152,3626535,976702,2649833,3.204,11.898,-837069,-2.746,18.303,(D),(D),(D)
2011,a) 1 to 4,2943306,2949237,6600004,6611299,480866,16.247,502008,16.961,1780503,1114193,666310,16.853,26.931,1803535,1118713,684822,16.921,27.28,-23032,-0.348,53.862,371810,373903,866688
2011,b) 5 to 9,933980,949489,6490066,6532304,33111,3.486,33528,3.53,1142476,409662,732814,6.271,17.49,1225895,412972,812923,6.322,18.767,-83419,-1.277,34.979,26254,27729,345674
2011,c) 10 to 19,567156,607287,7889193,7874079,16212,2.673,14773,2.436,1158813,349981,808832,4.445,14.717,1127708,321203,806505,4.079,14.322,31105,0.395,28.644,10238,11898,274719
2011,d) 20 to 99,462110,654330,18606470,18415296,22239,3.417,15200,2.336,2371526,645305,1726221,3.504,12.878,1987893,536736,1451157,2.915,10.795,383633,2.083,21.59,5827,8996,429171
2011,e) 100 to 499,80926,355475,15765132,15589768,17571,4.979,12363,3.504,1846812,426130,1420682,2.733,11.846,1496355,327219,1169136,2.099,9.598,350457,2.248,19.197,469,1926,159415
2011,f) 500 to 999,9413,122059,5927442,5843119,6236,5.127,5397,4.437,686326,148468,537858,2.541,11.746,517297,102689,414608,1.757,8.853,169029,2.893,17.706,16,192,20032
2011,g) 1000 to 2499,5937,150412,8080595,7987108,9943,6.686,6539,4.397,883960,210054,673906,2.63,11.067,698419,165427,532992,2.071,8.744,185541,2.323,17.489,12,148,31053
2011,h) 2500 to 4999,2271,120266,6233798,6187855,7579,6.317,7015,5.847,631047,149575,481472,2.417,10.198,537597,134091,403506,2.167,8.688,93450,1.51,17.376,(D),(D),(D)
2011,i) 5000 to 9999,1285,121656,6497651,6416315,12326,10.314,8032,6.721,751144,218626,532518,3.407,11.707,583908,159380,424528,2.484,9.1,167236,2.606,18.201,(D),(D),(D)
2011,j) 10000+,1060,637147,30691592,30540459,48436,7.575,52975,8.285,3445565,841230,2604335,2.754,11.282,3137833,904413,2233420,2.961,10.274,307732,1.008,20.549,(D),(D),(D)
2012,a) 1 to 4,2985991,2989850,6708140,6614378,496067,16.728,447494,15.09,1843503,1147549,695954,17.349,27.871,1654798,1014567,640231,15.339,25.018,188705,2.853,50.036,333589,335577,797159
2012,b) 5 to 9,934335,946919,6565246,6512494,32235,3.402,33205,3.505,1157131,397430,759701,6.103,17.768,1052061,379714,672347,5.831,16.155,105070,1.613,32.309,23923,25299,317300
2012,c) 10 to 19,561661,598025,7927388,7813868,19022,3.182,18667,3.122,1256154,397842,858312,5.091,16.076,1028354,344664,683690,4.411,13.161,227800,2.915,26.321,10309,11885,278556
2012,d) 20 to 99,471253,659419,19126486,18795390,24071,3.65,24129,3.659,2758107,752912,2005195,4.006,14.674,2094485,636169,1458316,3.385,11.144,663622,3.531,22.287,5982,9265,435424
2012,e) 100 to 499,81415,351818,15977036,15745063,15735,4.467,16608,4.715,2074536,438227,1636309,2.783,13.176,1613349,413051,1200298,2.623,10.247,461187,2.929,20.493,516,2304,186558
2012,f) 500 to 999,9878,124733,6215659,6114818,6254,5.017,6098,4.892,766632,144200,622432,2.358,12.537,565765,130228,435537,2.13,9.252,200867,3.285,18.505,25,232,34244
2012,g) 1000 to 2499,6134,148794,8251498,8140495,9541,6.449,7838,5.298,968414,216036,752378,2.654,11.896,743104,210778,532326,2.589,9.128,225310,2.768,18.257,14,34,46017
2012,h) 2500 to 4999,2343,122050,6295826,6217700,6638,5.441,6521,5.345,706191,150965,555226,2.428,11.358,547330,129749,417581,2.087,8.803,158861,2.555,17.606,(D),(D),(D)
2012,i) 5000 to 9999,1329,121161,6731431,6674469,8609,7.052,10429,8.543,789274,188827,600447,2.829,11.825,678885,221464,457421,3.318,10.171,110389,1.654,20.343,4,2088,56316
2012,j) 10000+,1118,647274,31379540,31356407,46699,7.198,49695,7.66,3344291,793336,2550955,2.53,10.665,3291627,895877,2395750,2.857,10.497,52664,0.168,20.995,0,0,0
2013,a) 1 to 4,2990806,2994580,6675923,6636372,478204,16.036,453228,15.198,1773082,1099639,673443,16.57,26.718,1692243,1035869,656374,15.609,25.5,80839,1.218,50.999,339982,341011,813632
2013,b) 5 to 9,937598,949308,6584705,6530135,32297,3.407,29632,3.126,1125379,398286,727093,6.099,17.234,1015971,363910,652061,5.573,15.558,109408,1.675,31.116,23568,24688,312911
2013,c) 10 to 19,566857,602161,7980219,7889644,18947,3.154,16157,2.689,1208360,389183,819177,4.933,15.316,1025755,336147,689608,4.261,13.001,182605,2.314,26.003,10476,11870,282245
2013,d) 20 to 99,480120,666375,19383866,19163179,23241,3.497,19746,2.971,2518789,681574,1837215,3.557,13.144,2074437,606471,1467966,3.165,10.825,444352,2.319,21.65,6249,8633,458497
2013,e) 100 to 499,83607,354633,16417447,16165543,16611,4.702,13865,3.925,2027101,431114,1595987,2.667,12.54,1521810,406748,1115062,2.516,9.414,505291,3.126,18.828,585,1362,201974
2013,f) 500 to 999,10094,124397,6334185,6259759,6822,5.505,5858,4.727,774567,161093,613474,2.573,12.374,624223,156134,468089,2.494,9.972,150344,2.402,19.944,35,398,49605
2013,g) 1000 to 2499,6332,148374,8256173,8160869,9934,6.726,8593,5.818,964762,233909,730853,2.866,11.822,773956,194263,579693,2.38,9.484,190806,2.338,18.967,14,615,41112
2013,h) 2500 to 4999,2453,131853,6736768,6654754,9098,6.947,7308,5.58,795160,191834,603326,2.883,11.949,632126,152134,479992,2.286,9.499,163034,2.45,18.998,3,52,16319
2013,i) 5000 to 9999,1300,121643,6565342,6495064,10087,8.325,9127,7.533,771480,222144,549336,3.42,11.878,629685,172436,457249,2.655,9.695,141795,2.183,19.39,0,0,0
2013,j) 10000+,1137,653570,32431567,32343790,51138,7.802,54850,8.369,3508604,1011237,2497367,3.127,10.848,3343283,1033019,2310264,3.194,10.337,165321,0.511,20.673,0,0,0
2014,a) 1 to 4,3005893,3010299,6715858,6644393,482452,16.123,446392,14.918,1795106,1112352,682754,16.741,27.017,1648276,1012836,635440,15.243,24.807,146830,2.21,49.614,339410,340435,805033
2014,b) 5 to 9,940085,953205,6621578,6553100,31425,3.302,28652,3.01,1129200,389720,739480,5.947,17.232,992944,357465,635479,5.455,15.152,136256,2.079,30.305,23450,24537,310469
2014,c) 10 to 19,574334,610048,8101170,8004235,17635,2.897,15100,2.48,1206839,376624,830215,4.705,15.078,1012512,335228,677284,4.188,12.65,194327,2.428,25.299,10696,12099,286455
2014,d) 20 to 99,489528,677246,19829512,19536359,23796,3.534,15880,2.359,2489003,723687,1765316,3.704,12.74,1901606,565635,1335971,2.895,9.734,587397,3.007,19.467,6057,9273,444704
2014,e) 100 to 499,85757,360965,16848892,16575911,19207,5.38,11344,3.177,1946034,507307,1438727,3.061,11.74,1400814,342493,1058321,2.066,8.451,545220,3.289,16.902,546,1936,187092
2014,f) 500 to 999,10319,124706,6488747,6392259,7503,6.073,5194,4.204,806158,191261,614897,2.992,12.611,612307,130307,482000,2.039,9.579,193851,3.033,19.158,19,215,28681
2014,g) 1000 to 2499,6271,153815,8515301,8366415,11987,7.92,7052,4.659,1020980,265593,755387,3.175,12.203,722454,157461,564993,1.882,8.635,298526,3.568,17.27,5,133,16452
2014,h) 2500 to 4999,2533,133444,6875725,6805048,8686,6.502,8975,6.718,776970,203414,573556,2.989,11.418,632503,143336,489167,2.106,9.295,144467,2.123,18.589,(D),(D),(D)
2014,i) 5000 to 9999,1354,126491,6818057,6750092,9209,7.342,7071,5.638,767390,221274,546116,3.278,11.369,632624,163190,469434,2.418,9.372,134766,1.997,18.744,(D),(D),(D)
2014,j) 10000+,1145,675174,33183126,33042057,57255,8.553,45709,6.828,3595425,1003194,2592231,3.036,10.881,3316210,883677,2432533,2.674,10.036,279215,0.845,20.073,0,0,0
2015,a) 1 to 4,3025232,3029914,6748082,6667919,487964,16.229,441745,14.692,1811219,1124488,686731,16.864,27.163,1651957,1014004,637953,15.207,24.775,159262,2.388,49.549,338840,339963,808320
2015,b) 5 to 9,944283,957881,6660311,6586154,31252,3.266,28992,3.03,1138419,388388,750031,5.897,17.285,990611,364263,626348,5.531,15.041,147808,2.244,30.082,23476,24703,313009
2015,c) 10 to 19,581972,617908,8231372,8115262,17741,2.877,15237,2.471,1233116,385030,848086,4.745,15.195,1001739,346871,654868,4.274,12.344,231377,2.851,24.688,11063,12409,297206
2015,d) 20 to 99,502319,693161,20377497,20052230,25851,3.754,16934,2.459,2596578,773077,1823501,3.855,12.949,1948850,614333,1334517,3.064,9.719,647728,3.23,19.438,6773,10093,492562
2015,e) 100 to 499,87829,366878,17283061,17008302,21377,5.895,12880,3.552,2037129,535756,1501373,3.15,11.977,1487244,354942,1132302,2.087,8.744,549885,3.233,17.488,550,2191,191225
2015,f) 500 to 999,10511,128941,6608773,6507456,8650,6.8,5186,4.077,811570,221287,590283,3.401,12.471,610608,135564,475044,2.083,9.383,200962,3.088,18.766,32,252,42920
2015,g) 1000 to 2499,6459,156872,8775594,8631406,12496,8.082,7999,5.173,1050116,284980,765136,3.302,12.166,762232,166472,595760,1.929,8.831,287884,3.335,17.662,6,451,17216
2015,h) 2500 to 4999,2519,133432,6964977,6867279,8984,6.774,7375,5.561,812546,191464,621082,2.788,11.832,617916,159293,458623,2.32,8.998,194630,2.834,17.996,5,501,32715
2015,i) 5000 to 9999,1351,129514,7007363,6911227,9252,7.217,6619,5.163,788407,222384,566023,3.218,11.408,595917,141511,454406,2.048,8.622,192490,2.785,17.245,0,0,0
2015,j) 10000+,1238,694667,34470111,34224706,58103,8.386,54478,7.863,3933975,1180652,2753323,3.45,11.495,3423791,880133,2543658,2.572,10.004,510184,1.491,20.008,0,0,0
2016,a) 1 to 4,3062275,3067233,6817408,6710861,507441,16.728,439939,14.503,1866045,1173153,692892,17.481,27.806,1651754,1006759,644995,15.002,24.613,214291,3.193,49.226,343986,345141,818392
2016,b) 5 to 9,952553,966856,6737883,6651987,33101,3.43,29449,3.052,1179447,411588,767859,6.187,17.731,1008657,370881,637776,5.575,15.163,170790,2.568,30.326,24356,25489,324804
2016,c) 10 to 19,590797,627193,8361222,8246707,18382,2.937,15697,2.508,1265252,399456,865796,4.844,15.343,1037312,358817,678495,4.351,12.579,227940,2.764,25.157,11535,12978,311488
2016,d) 20 to 99,513946,705748,20781076,20512740,25857,3.688,16603,2.368,2621608,772154,1849454,3.764,12.78,2084049,631840,1452209,3.08,10.16,537559,2.621,20.32,6943,9986,505603
2016,e) 100 to 499,89478,374150,17597238,17360592,20852,5.634,12722,3.438,2025133,521040,1504093,3.001,11.665,1549825,361562,1188263,2.083,8.927,475308,2.738,17.855,591,2501,203794
2016,f) 500 to 999,10626,131092,6697961,6619200,8775,6.78,5429,4.195,810349,194965,615384,2.945,12.242,653497,129015,524482,1.949,9.873,156852,2.37,19.745,29,508,38257
2016,g) 1000 to 2499,6485,158782,8855593,8770686,11774,7.491,8545,5.437,1028232,286516,741716,3.267,11.724,856137,171008,685129,1.95,9.761,172095,1.962,19.523,12,874,33601
2016,h) 2500 to 4999,2556,137591,7124705,7059335,9106,6.678,6655,4.88,775179,198811,576368,2.816,10.981,647249,130691,516558,1.851,9.169,127930,1.812,18.337,(D),(D),(D)
2016,i) 5000 to 9999,1406,136442,7201612,7154455,12469,9.355,6173,4.631,793273,223724,569549,3.127,11.088,693257,164577,528680,2.3,9.69,100016,1.398,19.38,(D),(D),(D)
2016,j) 10000+,1297,731943,35478312,35311384,56521,7.835,35494,4.92,3622436,1010334,2612102,2.861,10.259,3300177,923410,2376767,2.615,9.346,322259,0.913,18.692,(D),(D),(D)
2017,a) 1 to 4,3079226,3083498,6759546,6726145,495484,16.181,452733,14.785,1776795,1125332,651463,16.731,26.416,1710558,1034255,676303,15.377,25.431,66237,0.985,50.863,356952,358298,842200
2017,b) 5 to 9,954229,966586,6722299,6674007,33131,3.429,32218,3.335,1153146,410432,742714,6.15,17.278,1057013,390439,666574,5.85,15.838,96133,1.44,31.676,25193,26413,336439
2017,c) 10 to 19,596971,631035,8427895,8351492,19304,3.057,20034,3.173,1283462,408102,875360,4.887,15.368,1131331,411106,720225,4.923,13.546,152131,1.822,27.093,12737,14566,345526
2017,d) 20 to 99,520733,709648,21056850,20811531,24907,3.511,24601,3.467,2928612,801014,2127598,3.849,14.072,2439236,803141,1636095,3.859,11.721,489376,2.351,23.441,8153,12037,601383
2017,e) 100 to 499,90537,372701,17883859,17628805,17794,4.783,16406,4.41,2453359,499786,1953573,2.835,13.917,1942826,495380,1447446,2.81,11.021,510533,2.896,22.041,692,2387,240114
2017,f) 500 to 999,10845,133422,6861658,6737595,8058,6.086,6004,4.535,918596,205144,713452,3.045,13.634,671479,147849,523630,2.194,9.966,247117,3.668,19.932,28,514,40424
2017,g) 1000 to 2499,6683,161221,8995621,8930715,10801,6.75,8399,5.249,1027794,232324,795470,2.601,11.509,893861,237451,656410,2.659,10.009,133933,1.5,20.018,17,692,55114
2017,h) 2500 to 4999,2667,139542,7128036,7088447,8961,6.427,8724,6.257,800893,186819,614074,2.636,11.299,721357,189311,532046,2.671,10.177,79536,1.122,20.353,6,425,34989
2017,i) 5000 to 9999,1482,137334,7220607,7118928,12003,8.872,7926,5.858,905016,271907,633109,3.819,12.713,701484,184328,517156,2.589,9.854,203532,2.859,19.708,0,0,0
2017,j) 10000+,1342,736947,36248621,36282737,42606,5.715,59722,8.011,3677307,967894,2709413,2.668,10.135,3748245,1139133,2609112,3.14,10.331,-70938,-0.196,20.27,0,0,0
2018,a) 1 to 4,3092334,3095917,6794775,6727337,494651,16.084,453844,14.757,1801459,1124257,677202,16.712,26.778,1662817,1027000,635817,15.266,24.717,138642,2.061,49.435,369741,371050,860249
2018,b) 5 to 9,958261,970137,6788389,6713936,33436,3.45,31483,3.248,1211683,431777,779906,6.431,18.047,1062362,396513,665849,5.906,15.823,149321,2.224,31.646,26288,27504,351394
2018,c) 10 to 19,601829,635027,8512523,8439828,15725,2.472,17827,2.803,1269111,390715,878396,4.629,15.037,1124290,390483,733807,4.627,13.321,144821,1.716,26.642,12837,14851,346924
2018,d) 20 to 99,526146,707654,21238853,21086699,14617,2.059,19468,2.742,2615737,664608,1951129,3.152,12.405,2312441,677896,1634545,3.215,10.966,303296,1.438,21.933,7749,12711,573264
2018,e) 100 to 499,91623,372997,18142646,17948105,13479,3.618,12547,3.368,2097664,408442,1689222,2.276,11.687,1709130,408633,1300497,2.277,9.523,388534,2.165,19.045,739,3857,254933
2018,f) 500 to 999,10915,136071,7020617,6931231,7648,5.658,5836,4.318,873130,198430,674700,2.863,12.597,694755,131760,562995,1.901,10.024,178375,2.573,20.047,26,882,35003
2018,g) 1000 to 2499,6559,163964,9248760,9144653,11489,7.075,8321,5.124,1063446,270607,792839,2.959,11.629,860113,191265,668848,2.092,9.406,203333,2.224,18.811,15,877,48462
2018,h) 2500 to 4999,2467,136563,7147763,7064896,8155,5.917,10694,7.759,822606,208174,614432,2.947,11.644,654593,172954,481639,2.448,9.265,168013,2.378,18.531,4,225,26385
2018,i) 5000 to 9999,1356,136144,7307905,7258243,9391,6.956,7116,5.271,807771,172077,635694,2.371,11.129,700087,162489,537598,2.239,9.645,107684,1.484,19.291,0,0,0
2018,j) 10000+,1191,744295,37386250,37188277,39415,5.273,45774,6.124,3547924,916182,2631742,2.464,9.54,3149916,868807,2281109,2.336,8.47,398008,1.07,16.94,0,0,0
2019,a) 1 to 4,3117219,3121750,6804522,6767017,503786,16.237,465625,15.007,1786856,1139420,647436,16.838,26.405,1710452,1056927,653525,15.619,25.276,76404,1.129,50.553,407149,408804,939908
2019,b) 5 to 9,958226,971119,6731089,6738117,31081,3.196,33728,3.468,1132938,408356,724582,6.06,16.814,1146444,426633,719811,6.332,17.014,-13506,-0.2,33.628,29631,31142,393692
2019,c) 10 to 19,606238,639476,8553315,8513793,14819,2.314,16892,2.637,1226630,382609,844021,4.494,14.408,1147710,395724,751986,4.648,13.481,78920,0.927,26.961,13759,15746,370188
2019,d) 20 to 99,532190,707863,21522857,21307915,15758,2.228,14836,2.097,2533568,680629,1852939,3.194,11.89,2105211,615673,1489538,2.889,9.88,428357,2.01,19.76,7615,11170,544091
2019,e) 100 to 499,93274,373181,18473137,18215061,20193,5.473,11801,3.198,2092211,560708,1531503,3.078,11.486,1572359,346313,1226046,1.901,8.632,519852,2.854,17.264,635,2637,220912
2019,f) 500 to 999,11126,138160,7137606,7052108,9253,6.781,5843,4.282,863462,224145,639317,3.178,12.244,693630,140164,553466,1.988,9.836,169832,2.408,19.672,33,626,45661
2019,g) 1000 to 2499,6741,166741,9556178,9412991,11029,6.679,7820,4.735,1090162,303085,787077,3.22,11.581,802149,164865,637284,1.751,8.522,288013,3.06,17.043,10,217,29887
2019,h) 2500 to 4999,2552,140944,7194288,7124326,7748,5.515,6839,4.868,788992,228511,560481,3.207,11.075,648365,149043,499322,2.092,9.101,140627,1.974,18.201,(D),(D),(D)
2019,i) 5000 to 9999,1444,137000,7546060,7504061,6709,4.913,5825,4.266,730411,174730,555681,2.328,9.734,653182,135898,517284,1.811,8.704,77229,1.029,17.409,0,0,0
2019,j) 10000+,1244,755343,38269760,38018246,37454,4.963,35950,4.764,3276822,738155,2538667,1.942,8.619,2811764,793859,2017905,2.088,7.396,465058,1.223,14.792,(D),(D),(D)
